关键字	简体	越南
key	cn	vn
PalyerGuide1	貂蝉小姐乃是金枝玉叶，你好大的胆子！	Điêu Thuyền tiểu thư là kim chi ngọc diệp, tiểu tử nhà ngươi quả thật to gan !
PalyerGuide2	我呸！投弹车！给我灭了这群嚣张的小渣渣！	Ta khinh ! Xe bắn đá đâu ! Mau tiêu diệt hết bọn này cho ta !
PalyerGuide3	哇哈哈哈哈，大军前进，给我屠城！	Đại quân tiến lên, tàn sát toàn thành cho ta !
PalyerGuide4	老大快看！天空云里…有条巨龙！	Lão đại mau xem kìa ! Trên trời ngay đám mây… có 1 con cự long !
PalyerGuide5	上苍助我！我果然是天之骄子！	Trời xanh giúp ta ! Ta quả thật là con của ông trời !
PalyerGuide6	我咧个靠！活着的，带上貂蝉给我撤退！	Mau bắt theo Điêu Thuyền và rút quân hết cho ta !
PalyerGuide7	恩公尊姓大名？一定要帮我们救回貂蝉小姐！	Tôn tính đại danh của ân công là ? Nhất định phải giúp chúng tôi cứu được Điêu Thuyền về !
PalyerGuide8	姑娘别套近乎，神仙救人也是收费的。	Cô nương đừng thấy sang bắt quàng làm họ, ngay cả thần tiên cứu người cũng phải thu phí đấy !
PalyerGuide9	开仓放粮才能招兵买马，历史应该都一样吧…	Mở kho phân phát lương thực mới có thể chiêu binh mãi mã !
PalyerGuide10	兵马虽少，但菜刀够锋利，碰碰运气吧。	Binh mã tuy ít nhưng tinh nhuệ, thử liều một phen đi.
PalyerGuide11	我乃徐荣，发起狠来，连自己都害怕！	Ta là Từ Vinh, đã từng đánh bại Lý Mân !
PalyerGuide12	我学历不高，你可不要骗我…	Ngươi không dọa được ta đâu !
PalyerGuide13	小子！我家主公很欣赏你。	Tiểu tử ! Chủ công nhà ta rất yêu thích ngươi đấy.
PalyerGuide14	回去告诉吕布，他胡子太茂盛，不是我的菜。	Quay về nhắn với Lữ Bố ta sẽ đến tìm hắn !
PalyerGuide15	臭小子，一群菜刀队也想救貂蝉？	Tiểu tử thúi, với một đám tiểu tốt như vậy mà muốn cứu Điêu Thuyền hả ?
PalyerGuide16	你们这些跑龙套的台词还真单调…	Có vấn đề gì sao ?
PalyerGuide17	关卡进行中，总会有些意外的惊喜呢！	Chinh chiến quan ải sẽ có nhiều bất ngờ đặc biệt !
PalyerGuide18	回报来的太突然…好感动！	Cuối cùng cũng được đền đáp !
PalyerGuide19	这么高富帅的装备，恩公穿上试试吧！	Trang bị hảo hạng, ân công người mặc vào thử xem !
PalyerGuide20	貂蝉来信，劝你不要追了，她爱上吕布了！	Điêu Thuyền truyền thư, khuyên ngươi đừng đuổi nữa !
PalyerGuide21	喂喂喂，这明显不是貂蝉亲笔写的好吧！	Đây không phải bút tích của Điêu Thuyền !
PalyerGuide22	小老弟，你当我西凉没人了？	Tên nhãi kia, ngươi tưởng Tây Lương của ta hết người rồi sao ?
PalyerGuide23	嘿嘿嘿嘿，期待你终结我的无敌。	Ta đang đợi ngươi đến đây !
PalyerGuide24	恩公，你的裤子都跑开线了，还好吧？	Ân công, người vẫn ổn chứ ?
PalyerGuide25	呜呜呜…等我磨好菜刀，一定不会放过他！	Nhất định sẽ không tha cho hắn đâu !
PalyerGuide26	我穿越前是名优秀的城管，你怕不怕！？	Ngươi đã thấy sợ chưa ! ?
PalyerGuide27	听说你们会飞踹，我也想试试。	Ta cũng muốn thử thử xem !
PalyerGuide28	恩公，是时候给你招募一位将领了！	Ân công, đã đến lúc chiêu mộ tướng lĩnh rồi !
PalyerGuide29	呜呜呜…招个厉害的，回来一起报仇！	Hãy chiêu 1 tướng thật lợi hại, quay về cùng nhau báo thù !
PalyerGuide30	臭小子！这次绝不放过你！	Lần này quyết không tha cho ngươi !
PalyerGuide31	传说中的图纸？恩公，我们发财啦！	Bản đồ trong truyền thuyết ? Ân công , chúng ta phát tài to rồi !
PalyerGuide32	先收着，估计以后用得着…	Cứ giữ đó đi, không chừng sau này sẽ cần dùng đến đấy…
PalyerGuide33	恩公若是花些小钱，是可以招募到一些新武将的。	Ân công nếu dùng một ít tiền, sẽ chiêu mộ được một số Võ Tướng mới đấy.
PalyerGuide34	万一招不到，岂不亏大了…	Nếu lỡ như không chiêu được, há không phải lỗ nặng rồi sao…
E_STR_LOGIN_OUT_OF_DATE	登陆过期，请主公重新登陆	Đăng nhập quá hạn, hãy thử đăng nhập lại xem
E_STR_ACIVE	活跃度+%d	Độ hoạt động +%d
E_STR_LVL_5_OPEN	5级开放.	Cấp 5 mở
E_STR_LVL_13_OPEN	13级开放.	Cấp 13 mở
E_STR_LVL_19_OPEN	19级开放.	Cấp 19 mở
E_STR_LVL_21_OPEN	21级开放.	Cấp 21 mở
E_STR_LVL_38_OPEN	38级开放.	Cấp 38 mở
E_STR_TIME_DAYDS_AGO	%d天前	%d ngày trước
E_STR_TIME_HOURS_AGO	%d小时前	%d giờ trước
E_STR_TIME_MINS_AGO	%d分钟前	%d phút trước
E_STR_TIME_JUST_NOW	刚刚	Vừa mới
E_STR_YOU_CHALLENGE	你挑战了	Ngươi đã khiêu chiến rồi 
E_STR_CHALLENGE_YOU	挑战了你，	 khiêu chiến ngươi, 
E_STR_YOU_WIN	你战胜了	ngươi chiến thắng rồi 
E_STR_YOU_DEFEATED	你战败了	ngươi chiến bại rồi 
E_STR_UP_TO_RANK	升至第%d名	Thăng đến hạng %d 
E_STR_DOWN_TO_RANK	降至第%d名	Giáng đến hạng %d
E_STR_RANKING_UNCHANGED	排名不变	Xếp hạng không đổi
E_STR_DEFAULT_NAME_STR	玩家：%s	Người chơi: %s
E_STR_DEFAULT_RANK_STR	排名：%d	Hạng: %d
E_STR_NO_DATE	没数据	Không có số liệu
E_STR_COUNTDOWN	倒计时:	Còn:
E_STR_GOLD	金币	Vàng 
E_STR_HONOR	军功	Quân Công 
E_STR_SOUL	将魂	Tướng Hồn
E_STR_CONFIRM_MAKE_SOUL	化魂后该卡牌消失，并转化为%d个将魂，确定化魂吗？	Sau khi hóa hồn thì thẻ này sẽ biến mất, và chuyển thành %d Tướng Hồn, đồng ý hóa hồn ?
E_STR_NO_EQUIPMENT	暂无装备	Tạm hết trang bị
E_STR_MATERIAL_NOT_ENOUGH_AND_BUY	所需材料不足,是否前去购买？	Tài nguyên cần thiết không đủ, đồng ý mua ?
E_STR_MATERIAL_NOT_ENOUGH	所需材料不足！	Tài nguyên cần thiết không đủ !
E_STR_LUCK_GEM_NOT_ENOUGH_AND_BUY	所需幸运宝石不足,是否前去购买？	Hạnh vận Ngọc cần thiết không đủ, đồng ý mua ?
E_STR_GOLD_NOT_ENOUGH	主公!金币不够啊!	Chủ Công ! Vàng không đủ ! 
E_STR_EQUIP_NOT_EXCEED_LIMIT	主公装备等级不能超过君主等级啊	Cấp trang bị không thể vượt quá Cấp Quân Chủ
E_STR_SUCCESS_RATE	成功率%d%%	Tỉ lệ thành công %d%%
E_STR_REACHED_LEVEL_TO_SETIN_GEM	强化%d级开启	Cường hóa cấp %d mở
E_STR_ATTR_ATTACK_NAME	武力	Võ Lực 
E_STR_ATTR_MAGIC_NAME	谋略	Mưu Lược 
E_STR_ATTR_DEFENSE_NAME	武防	Võ Phòng 
E_STR_ATTR_MAGIC_DEFENSE_NAME	谋防	Mưu Phòng 
E_STR_ATTR_SOLDIER_NAME	士兵	Binh Lực 
E_STR_ATTR_CRITICAL_NAME	暴击	Bạo Kích
E_STR_ATTR_FORTITUDE_NAME	刚毅	Cương Nghị
E_STR_ATTR_BLOCK_NAME	格挡	Đỡ 
E_STR_ATTR_GEM_START	开启	Mở
E_STR_ATTR_GEM_UPGRADE	升级	Tăng cấp 
E_STR_GEM_MAX_LIMIT_INFO	当前宝石为最高级	Ngọc hiện tại đạt cấp cao nhất 
E_STR_WEAR_FROM	装备与%s	%s
E_STR_SELECTED_CARDS_NUM	已选武将卡牌数:%d	Số thẻ Võ Tướng đã chọn: %d
E_STR_NO_ROLE_CARD_SELETED	还没有选择武将卡牌！	Vẫn chưa chọn thẻ Võ Tướng !
E_STR_EXCHANGE_SOUL_SUCCESS	魂级提升	Tăng cấp hồn
E_STR_EXCHANGE_SOUL_FAILED	炼魂失败	Luyện hồn thất bại
E_STR_ALREADY_MAX_LEVEL	已到满级	Đã đầy cấp
E_STR_UPGRADE_LEVEL	升级	Tăng cấp 
E_STR_UNEQUIP	卸下	Tháo
E_STR_SELECT_CARD_FULL	最多选择4张武将卡牌	Tối đa chọn 4 thẻ Võ Tướng 
E_STR_REACH_MAX_SOUL_LEVEL	当前已最高级炼魂，敬请期待	Hiện tại đã luyện hồn cấp cao nhất, hãy chờ đợi
E_STR_NO_CARD_TO_SOUL	背包里已经没有可用的卡牌，请前往招贤馆进行招募或兑换	Trong túi đã hết thẻ, hãy đến Tửu Quán chiêu mộ hoặc đổi
E_STR_ROLE_ALREADY_REGISTERED	该武将已激活，请选择其他卡牌	Võ Tướng này đã kích hoạt, hãy chọn thẻ khác 
E_STR_ROLE_SIEZ_LIMIT	武将位已满，请优先进入“武将”界面解雇武将！	Võ Tướng đã đầy, hãy vào “Võ Tướng” sa thải bớt ! 
E_STR_ATTR_MORALE_NAME	士气	Sĩ Khí
E_STR_LEAVE_AT_LEAST_ONE_ROLE	至少保留一名武将上阵！	Giữ lại ít nhất 1 Võ Tướng xuất trận !
E_STR_ONE	一手	Lượt 1
E_STR_TWO	二手	Lượt 2
E_STR_THREE	三手	Lượt 3
E_STR_FOUR	四手	Lượt 4
E_STR_FIVE	五手	Lượt 5
E_STR_SIX	六手	Lượt 6
E_STR_SEVEN	七手	Lượt 7
E_STR_EIGHT	八手	Lượt 8
E_STR_NINE	九手	Lượt 9
E_STR_DEFENDER	守关将领	Thủ Quan Tướng Lĩnh
E_STR_ELITE_INSTANCE	精英副本	Phụ Bản Tinh Anh 
E_STR_SWEEP_NUMBER	第%d轮扫荡	Càn quét vòng %d
E_STR_SWEEP_OVER	扫荡结束	Càn quét kết thúc
E_STR_ATTACK	攻击	Công kích
E_STR_USER_EXP	君主经验	Exp Quân Chủ 
E_STR_ROLE_EXP	武将经验	Exp Võ Tướng 
E_STR_FOOD_ENOUGH	没有足够的粮草	Không đủ Lúa 
E_STR_BUY	购买	Mua
E_STR_HONOR_ENOUGH	主公!军功不够啊!	Chủ Công ! Quân Công không đủ !
E_STR_CASH_ENOUGH	主公!元宝不够啊!	Chủ Công ! KNB không đủ !
E_STR_UNABLE_TO_TRANSFER_POWER	该武将经验值为0，无法传功	Võ Tướng này Exp là 0, không thể truyền thừa
E_STR_CAN_NOT_BE_DISMISSED	该武将已上阵，无法解雇。是否前往布阵移除该武将？	Võ Tướng này đang xuất trận, không thể sa thải. Đến bố trận bỏ Võ Tướng này ?
E_STR_CONFIRM_DISMISSAL	主公，您确认要解雇当前武将吗？	Chủ Công, chắc chắn muốn sa thải Võ Tướng này chứ ?
E_STR_CAN_NOT_BUY	货币不够，不能购买！	Không đủ tiền, không thể mua !
E_STR_EQUIP_SKILL_SUCCESS	装备技能成功	Trang bị kỹ năng thành công
E_STR_EQUIP_SKILL_FAILURE	装备技能失败	Trang bị kỹ năng thất bại
E_STR_UPGRADE_SUCCESSFUL	升级成功	Tăng cấp thành công
E_STR_UPGRADE_FAILS	技能书不够，是否前往购买？	Sách kỹ năng không đủ, đồng ý đi mua ?
E_STR_REACHED_MAX_LEVEL	满级	Đầy cấp
E_STR_TRANSFOR_SOLDIER_FAILED	条件不满足，无法进阶。	Điều kiện không đủ, không thể tiến cấp.
E_STR_ADDITION_SUCCESSS_RATE	每张增加成功率%d%%	Mỗi tấm tăng tỉ lệ thành công %d%%
E_STR_SHANG_ZHEN_ROLE	上阵人数%d/%d,还可以上阵%d人	Võ Tướng xuất trận %d/%d còn có thể xuất trận %d người 
E_STR_SKILL_LIMIT	每日技能书合成次数%d	Số lần ghép sách kỹ năng mỗi ngày %d
E_STR_SKILL_TIMES_OVER	今日使用次数已用完，请明天再来	Đã dùng hết số lần hôm nay, ngày mai quay lại nhé !
E_STR_ACIVE_SKILL_SUCCEED	合成成功	Ghép thành công 
E_STR_SHAO_XIA	你的%s	%s của ngươi 
E_STR_CHUAN_GONG_SUCCEED	传功成功	Truyền công thành công
E_STR_EXCHANGE_ONLY_ORANGE	血将和橙将才可炼魂	Huyết tướng và Kim Tướng mới được luyện hồn 
E_STR_TRANSFER	进阶	Tiến cấp 
E_STR_SKILL_BOOK_ROBED	你的%s被抢了%d个	%s của ngươi đã bị cướp %d cái 
E_STR_FRAGMENT_LEVEL_LIMIT	残卷抢夺%d级后开启	Cướp Tàn Quyển sau cấp %d mở 
E_STR_SHANG_ZHEN_ROLE_EX	上阵人数%d/%d,%d级还可上阵%d人	Võ Tướng xuất trận %d/%d, cấp %d còn có thể xuất trận %d người 
E_STR_GOLDMINE_WITHDRAWAL	我军从金矿撤出，%d金币收入囊中.	Quân ta rút lui từ Ngân Khoáng, được %d Vàng
E_STR_OCCUPATION_TIMES_RUN_OUT	你今天占领次数已经用完.	Bạn đã dùng hết số lần chiếm hôm nay 
E_STR_HAS_OCCUPIED_GOLDMINE	你已经占领了一个金矿	Bạn đã chiếm được 1 Ngân Khoáng 
E_STR_GOOD_ROLE_LEAVE_PROMT	橙色和红色品质武将可完成成就或者用于炼魂确认要清场送客？	Võ Tướng phẩm chất cam và đỏ có thể dùng hoàn thành Nhiệm Vụ hoặc luyện hồn, đuổi đi ?
E_STR_SOLDIER_CONDITION	条件不足，无法进阶	Điều kiện không đủ, không thể tiến cấp.
E_STR_ITEMNOTCOUNT	物品数量不足，请购买！	Số lượng vật phẩm không đủ, hãy mua !
E_STR_TRAINLIMET	培养已达上限，请进阶	Bồi dưỡng đã đạt giới hạn, hãy tiến cấp 
E_STR_ARENA_CASH_FIGHT_UNENOUGH	需要花费%d元宝,请购买.	Cần dùng %d KNB, hãy mua.
E_STR_ARENA_CASH_FIGHT	本次挑战将花费%d元宝，是否继续挑战？（剩余额外挑战：%d次）	Khiêu chiến lần này dùng %d KNB, tiếp tục ? (Khiêu chiến còn lại: %d lần)
E_STR_PLUNDER_YOUR_GOLDMINE	掠夺了你的金矿，慌乱中你只拿走了%d金币！	 đã cướp Ngân Khoáng của ngươi, trong lúc hoảng loạn chỉ mang theo %d Vàng !
E_STR_SNATCHED_GOLD	的金矿，你抢走了%d金币！	, cướp đi %d Vàng !
E_STR_YOU_PLUNDERED	你掠夺了	Ngươi đã cướp Ngân Khoáng của 
E_STR_KEEP_MINE_SUCCESS	胆敢掠夺你的金矿，被你打败！金矿里增加%d金币！	 cả gan dám cướp Ngân Khoáng của ngươi, bị ngươi đánh bại! Trong Ngân Khoáng tăng %d Vàng !
E_STR_GRAB_MINE_FAILED	的金矿，但失败了，输了%d金币！	, cướp thất bại rồi, mất %d Vàng ! 
E_STR_YOU_WANT_TO_PLUNDER	你想掠夺	Ngươi cướp Ngân Khoáng của 
E_STR_SOMEONE_CHALLENGE_YOU	在擂台挑战了你	Khiêu chiến ngươi tại Lôi Đài 
E_STR_YOU_WIN_RANKING_UNCHANGED	你战胜了！排名不变	Ngươi chiến thắng rồi ! Xếp hạng không đổi 
E_STR_YOU_WIN_RANK_UP	你战胜了！升至第%d名	Ngươi chiến thắng rồi ! Thăng đến hạng %d
E_STR_YOU_DEFEATED_RANKING_UNCHANGED	你战败了！排名不变	Ngươi chiến bại rồi ! Xếp hạng không đổi 
E_STR_YOU_DEFEATED_RANK_DOWN	你战败了！降至第%d名	Ngươi chiến bại rồi ! Giáng đến hạng %d
E_STR_PUT_YOUR_ARRESTING	我方将领英勇奋战，但依然寡不敌众，最后被%s俘虏	Tướng lĩnh của ta đã chiến đấu anh dũng, nhưng thiểu số không thắng nổi đa số, cuối cùng bị %s bắt làm tù binh
E_STR_GOLD_TIME	金币/小时	Vàng/giờ
E_STR_ZHANLING_GOLD	你成功占领了一个空的矿坑	Ngươi thành công chiếm được mỏ trống 
E_STR_ZHANLING_GOLD_TIP	没有多余的矿坑啦，只能选择掠夺或者占领其他品质的金矿	Không có dư mỏ nữa rồi, chỉ có thể chọn cướp hoặc chiếm Ngân Khoáng khác thôi 
E_STR_ZHANLING_GOLD_ING	你当前已经占领了一座金矿	Hiện tại ngươi đã chiếm được 1 Ngân Khoáng 
E_STR_CHE_JUN	占领时间还未结束，撤军将获得当前积累的金币，确定撤军吗？	Thời gian chiếm vẫn còn, rút quân sẽ chỉ nhận được số Vàng tích lũy, đồng ý rút quân ?
E_STR_CAN_NOT_ZHANLING	你的失败保证金不足，不能掠夺该金矿，请选择其他人的金矿	Nếu thất bại không đủ Vàng bồi thường, không thể cướp Ngân Khoáng này, hãy chọn Ngân Khoáng khác
E_STR_GOLDMINE_LEVEL	%d-%d级	Cấp %d-%d
E_STR_GOLDMINE_BY_NONE	没有可掠夺的矿坑	Không có Ngân Khoáng có thể cướp 
E_STR_GOLDMINE_BY_CASH	你确定要花费%d元宝占领金矿吗	Đồng ý dùng %d KNB chiếm Ngân Khoáng ?
E_STR_GOLDMINE_HAVE_NONE	今日没有占领和掠夺次数了	Hôm nay đã hết số lần chiếm và cướp rồi 
E_STR_GOLDMINE_GET_GOLD_BACK	我军久占金矿无人能与之抗衡，获得 %d金币	Quân ta chiếm Ngân Khoáng đã lâu không ai có thể chống chọi lại được, nhận được %d Vàng
E_STR_GOLDMINE_CAPTURE	占领	Chiếm 
E_STR_GOLDMINE_DESPOIL	掠夺	Cướp 
E_STR_GOLDMINE_RETREATE	撤军	Rút quân
E_STR_GRAB_FRAGMENT	太不幸了，可恶的%s抢夺了你的%s，下次说不定就会抢走你的后宫美人！	Quá xui rồi, tên đáng ghét %s đã cướp %s của ngươi rồi, lần sau không chừng sẽ cướp luôn hậu cung mỹ nhân của ngươi đấy !
E_STR_GOLDMINE_FAILED	%s掠夺了你的金矿，慌乱中你只拿走了%d金币！	%s đã cướp Ngân Khoáng của ngươi, trong lúc hoảng loạn chỉ mang theo %d Vàng ! 
E_STR_GOLD_OPEN_LEVEL	君主等级%d级才能开启金矿	Quân Chủ cấp %d mới có thể mở Ngân Khoáng
E_STR_CATCH_TIMES_OVER	你的今日抓捕次数已用完，请明天再来	Số lần bắt giữ của ngươi hôm này đã hết, mời ngày mai quay lại 
E_STR_GET_GOLD	你获得了%d金币	Bạn nhận được %d Vàng 
E_STR_SEE_A_VISITOR_OUT	席位不足,请送客	Chỗ ngồi không đủ, mời tiễn khách
E_STR_MERCIER	名士	Danh Sĩ
E_STR_YOU_HAVE_ROLD	已拥有该武将，自动转换为卡牌	Đã sở hữu Võ Tướng này, tự động chuyển thành thẻ 
E_STR_ROLD_NUMBER_LIMIT	武将位超出上限，将自动转换为卡牌	Võ Tướng đã vượt giới hạn, sẽ tự động chuyển thành thẻ
E_STR_ORANGE_MESSAGEBOX	橙色和红色品质武将可完成成就或者用于炼魂确认要清场送客？	Võ Tướng phẩm chất cam và đỏ có thể dùng hoàn thành Nhiệm Vụ hoặc luyện hồn, đuổi đi ?
E_STR_RECRUIT_SUCCEED	招募成功	Chiêu mộ thành công
E_STR_GET_ROLE	获取武将	Nhận được Võ Tướng 
E_STR_CHANGE_CARD	转为卡牌	Chuyển thành thẻ
E_STR_CASH	元宝	KNB 
E_STR_TECH_NOT_EXCEED_LIMIT	等级达到上限，不能超过君主等级.	Cấp đạt giới hạn, không thể vượt quá cấp Quân Chủ 
E_STR_DEFAULT_THOUSAND_FLOOR_CASH_STR	你确定消耗%d元宝进行重置吗？重置后将返回重楼第一层	Ngươi đồng ý tiêu hao %d KNB tiến hành làm mới? Sau khi làm mới sẽ quay về trọng lâu tầng 1
E_STR_DEFAULT_THOUSAND_FLOOR_RESET_OVER	你今天的重置次数已经用完	Bạn đã dùng hết số lần làm mới hôm nay
E_STR_AUTO_CHALLENGE	自动挑战	Tự động khiêu chiến
E_STR_RESET_CAMPAIGN	重置战役	Làm mới lại chiến dịch
E_STR_FREE_RESET	是否免费重置该战役？重置后可以重新挑战该战役	Miễn phí làm mới chiến dịch ? Sau khi làm mới có thể khiêu chiến lại chiến dịch này
E_STR_CASH_RESET	是否花费%d元宝重置该战役？重置后可以重新挑战该战役	Dùng %d KNB làm mới chiến dịch ? Sau khi làm mới có thể khiêu chiến lại chiến dịch này 
E_STR_100_CASH_RESET	是否花费100元宝重置该战役？重置后可以重新挑战该战役	Dùng 100 KNB làm mới chiến dịch ? Sau khi làm mới có thể khiêu chiến lại chiến dịch này 
E_STR_CHALLENGING_TIMES_RUN_OUT	当前挑战次数已用完，剩余次数正在恢复中！	Đã dùng hết số lần khiêu chiến hôm nay, số lần còn lại đang hồi !
E_STR_FLOOR	第%d层	Tầng %d
E_STR_ROLES_NOT_ENOUGH	你必须有至少三名可以上阵的武将	Bạn nhất định phải có ít nhất 3 Võ Tướng để xuất trận 
E_STR_DEFAULT_THOUSAND_FLOOR_RESET_FIRST	本次重置免费，重置后返回第一层。	Miễn phí lần làm mới này, sau khi làm mới trở lại tầng 1 
E_STR_DEFAULT_THOUSAND_START	开战	Chiến 
E_STR_DEFAULT_THOUSAND_AUTO_TOWER	扫荡	Càn quét
E_STR_ZERO_FLOOR	当前已经是初始层，不能重置	Hiện tại đã là tầng mở đầu, không thể làm mới
E_STR_ALL_ROLE_EXP_THAN_USER_EXP	武将等级不能超过君主等级	Cấp Võ Tướng không thể vượt quá cấp Quân Chủ 
E_STR_SPEND_CASH_END	是否花费%d元宝立即结束？	Đồng ý dùng %d KNB để kết thúc ngay ?
E_STR_TRAINING_ROLE	训练武将	Huấn luyện Võ Tướng 
E_STR_ON_CLICK_OPENED	点击开启	Ấn để mở 
E_STR_UPGRADE_SILVER	是否花费200元宝升级为白银训练位	Dùng 200 KNB tăng thành Bạch Ngân huấn luyện
E_STR_UPGRADE_GOLD	是否花费500元宝升级为黄金训练位	Dùng 500 KNB tăng thành Hoàng Kim huấn luyện
E_STR_BECOME_A_VIP_OPEN	成为VIP1可以开启更多训练位	Trở thành VIP 1 có thể mở thêm nhiều ô huấn luyện
E_STR_BECOME_N_VIP_OPEN	成为VIP%d可以开启更多训练位	Trở thành VIP %d có thể mở thêm nhiều ô huấn luyện
E_STR_ONCLICK_TRAIN	点击训练	Ấn để huấn luyện
E_STR_ONCLICK_ADD_SPEED	点击加速	Ấn để tăng tốc
E_STR_UPDATA_TRAINCARD	升级训练位	Tăng cấp huấn luyện
E_STR_CANCEL_UPDATA	取消升级	Hủy tăng cấp
E_STR_ONCLICK_UPDATA	点击升级	Ấn để tăng cấp
E_STR_TRAINCARD_MAX	训练位已是最高等级	Huấn luyện đã là cấp cao nhất
E_STR_GO_OPEN	君主等级达到%d级开启	Quân Chủ đạt cấp %d mở 
E_STR_TRAINCARD_CLOSE	训练位冷却中，不能升级训练位	Ô huấn luyện đang hồi, không thể tăng cấp huấn luyện
E_STR_MAX_LEVEL_TRAINCARD	最高等级	Cấp cao nhất
E_STR_TRAIN_LIMIT	君主等级%d级开启	Quân Chủ cấp %d mở 
E_STR_SILVER_CASH_ENOUGH	升级到白银训练位需要%d元宝，当前元宝不足	Tăng cấp đến Bạch Ngân huấn luyện cần %d KNB, hiện tại KNB không đủ 
E_STR_GOLD_CASH_ENOUGH	升级到黄金训练位需要%d元宝，当前元宝不足	Tăng cấp đến Hoàng Kim huấn luyện cần %d KNB, hiện tại KNB không đủ 
E_STR_SPEED_CASH_ENOUGH	是否花费%d元宝立即结束，当前元宝不足	Đồng ý dùng %d KNB kết thúc ngay, hiện tại KNB không đủ 
E_STR_OPEN	%d级开启	Cấp %d mở
E_STR_LVL_40_OPEN	40级开放.	Cấp 40 mở
E_STR_STAY_TUNED	敬请期待	Hãy theo dõi nhé
E_STR_LVL_22_OPEN	22级开放.	Cấp 22 mở
E_STR_TEN_THOUSAND	%d万	%d Vạn 
E_STR_YESTERDAY	昨天	Hôm qua
E_STR_DAYS_AGO	%d天前%02d:%02d:%02d	%d ngày trước %02d:%02d:%02d
E_STR_BAG_TITLE_ALL	全部	Tất cả
E_STR_BAG_TITLE_ITEM	道具	Vật phẩm 
E_STR_BAG_TITLE_EQUIP	装备	Trang bị
E_STR_BAG_TITLE_CARD	卡牌	Thẻ tướng
E_STR_BAG_SUBTITLE_ALL	全部	Tất cả
E_STR_BAG_SUBTITLE_MATERIAL	材料	Tài nguyên
E_STR_BAG_SUBTITLE_GEM	宝石	Ngọc
E_STR_BAG_SUBTITLE_OTHER	其他	Khác
E_STR_BAG_SUBTITLE_WEAPON	武器	Vũ khí
E_STR_BAG_SUBTITLE_ARMOR	防具	Phòng cụ
E_STR_BAG_SUBTITLE_ACCESSORY	饰品	Trang sức
E_STR_BAG_SUBTITLE_RED	血卡	Thẻ huyết
E_STR_BAG_SUBTITLE_ORANGE	橙卡	Thẻ cam
E_STR_BAG_SUBTITLE_PURPLE	紫卡	Thẻ tím
E_STR_BAG_SUBTITLE_BLUE	蓝卡	Thẻ lam
E_STR_SHOP_TITLE_CASH	元宝	KNB 
E_STR_SHOP_TITLE_HONOR	军功	Quân Công 
E_STR_SHOP_SUBTITLE_C_MATERIAL	材料	Tài nguyên
E_STR_SHOP_SUBTITLE_C_GEM	宝石	Ngọc 
E_STR_SHOP_SUBTITLE_C_OTHER	其他	Khác
E_STR_SHOP_SUBTITLE_H_EQUIP	装备	Trang bị
E_STR_SHOP_SUBTITLE_H_MATERIAL	材料	Tài nguyên
E_STR_SHOP_SUBTITLE_H_OTHER	其他	Khác
E_STR_BAG_TO_SOUL	化魂	Hóa hồn
E_STR_BAG_TO_RESOLVE	分解	Phân giải
E_STR_TODAY_TIMES_OVER	今天次数已用完，请明天再来	Đã dùng hết số lần hôm nay, ngày mai quay lại nhé !
E_STR_YOUR_GAIN_GOLD	你获得了%d金币	Bạn nhận được %d Vàng 
E_STR_YOUR_GAIN_TWO	你获得了%d步	Bạn nhận được %d bước
E_STR_SOUL_ENOUGH	将魂不足	Tướng Hồn không đủ
E_STR_YOUR_GAIN_HONOR	你获得了%d军功	Bạn nhận được %d Quân Công 
E_STR_CURR_EXPERIENCE_SUCC_RATE	当前历练成功率：%d%%	Tỉ lệ thành công hiện tại: %d%%
E_STR_EXPERIENCE_ATTACK	武力	Võ Lực 
E_STR_EXPERIENCE_DEFENCE	武防	Võ Phòng 
E_STR_EXPERIENCE_RESIST	谋防	Mưu Phòng 
E_STR_EXPERIENCE_HEALTH	士兵	Binh Lực 
E_STR_EXPERIENCE_FORTITUDE	刚毅	Cương Nghị
E_STR_EXPERIENCE_HIT	命中	Chính Xác
E_STR_EXPERIENCE_UNBLOCK	破招	Phá Chiêu 
E_STR_EXPERIENCE_BLOCK	格挡	Đỡ 
E_STR_EXPERIENCE_CRITDAMAGE	暴击	Bạo Kích
E_STR_EXPERIENCE_MISS	躲闪	Né Tránh
E_STR_SOLDIER_NAME_DAO	刀兵	Đao Binh 
E_STR_SOLDIER_NAME_QIANG	枪兵	Thương Binh 
E_STR_SOLDIER_NAME_QI	骑兵	Kỵ Binh
E_STR_SOLDIER_NAME_MOU	谋士	Mưu Sĩ 
E_STR_SOLDIER_NAME_HONG	红颜	Vũ Cơ 
E_STR_SOLDIER_SUCC_RATE	当前历练成功率：%d%%	Tỉ lệ thành công hiện tại: %d%%
E_STR_SOLDIER_ADD_RATE	成功率+%d%%	Tỉ lệ thành công +%d%%
E_STR_EXPERIENCE_FAILURE	历练失败,再接再厉吧!	Tập luyện thất bại, hãy liên tục nỗ lực !
E_STR_ROLE_TRANSFER_SUCC	恭喜你！进阶成功	Chúc mừng ngươi ! Tiến cấp thành công 
E_STR_SUCC_ADD_RATE	成功增加历练成功率	Tăng tỉ lệ tập luyện thành công
E_STR_SUCC_FULL	成功率已满	Tỉ lệ thành công đã đầy
E_STR_ATTR_UPGRADE	该兵种的历练属性已刷新	Đã làm mới thuộc tính tập luyện binh chủng này
E_STR_SUCC_RATE_ZERO	当前成功率为0%,是否前去购买	Tỉ lệ thành công hiện tại là 0%, đồng ý đi mua ?
E_STR_ARENA_RANK	排名：%d	Hạng: %d
E_STR_ARENA_HONOR	声望：%d	Danh Vọng: %d
E_STR_ARENA_HONON_INC	+%d军功/小时	 + %d Quân Công/giờ
E_STR_ARENA_NRANK	第%d名	Hạng %d
E_STR_ARENA_NRANK_SECTION	%d-%d名	Hạng %d - %d
E_STR_ARENA_MANY_HONOR	军功：%s	Quân Công: %s
E_STR_ARENA_LEVEL	擂台等级：%d	Cấp Lôi Đài: %d
E_STR_ARENA_GET_REWARD	获得金币%d	Nhận được %d Vàng 
E_STR_ARENA_NO_FREE_COUNT	今日免费次数已用完，是否花费%d元宝继续挑战？	Đã dùng hết số lần miễn phí hôm nay, đồng ý dùng %d KNB tiếp tục khiêu chiến ?
E_STR_ARENA_GOT_REWARD	已领取	Đã nhận
E_STR_ARENA_FREE_COUNT_LEFT	本轮免费挑战次数%d	Số lần khiêu chiến còn: %d
E_STR_ARENA_COST_CASH	挑战需要消耗%d元宝	Khiêu chiến cần dùng %d KNB 
E_STR_ARENA_CURR_CAN_GET_REWARD	上轮排名阶段奖励(%s)	Lần trước (%s)
E_STR_ARENA_NEXT_REWARD	本轮排名阶段奖励(%s)	Lần này (%s)
E_STR_ARENA_CURR_RANK_REWARD	当前阶段奖励(%s)	Phần thưởng hạng hiện tại %s
E_STR_ARENA_NEXT_RANK_REWARD	下一阶段奖励(%s)	Phần thưởng hạng kế tiếp %s
E_STR_ARENA_CAN_GET	领取	Nhận
E_STR_PRISON_FREE_COUNT	今日还可免费抓捕%d个奴隶	Hôm nay miễn phí bắt giữ %d nô lệ
E_STR_PRISON_ONCLICK_CATCH	点击抓捕	Ấn để bắt giữ
E_STR_PRISON_SPEEDUP	加速	Tăng tốc
E_STR_PRISON_STATE_FREE	空闲	Nhàn rỗi
E_STR_PRISON_GET_GOLD	获得%d金币	Nhận được %d Vàng 
E_STR_CHAT_NOT_ENOUGH_XIAO	小喇叭不足，是否前去购买	Tiểu Lạt Bá không đủ, đi mua ?
E_STR_CHAT_NOT_ENOUGH_DA	大喇叭不足，是否前去购买	Đại Lạt Bá không đủ, đi mua ?
E_STR_CHAT_LEGION_CHAT_NOT_OPEN	军团聊天暂未开放	Quân Đoàn chat tạm chưa mở 
E_STR_CHAT_XIAOLABA_NAME	小喇叭	Tiểu Lạt Bá
E_STR_CHAT_DALABA_NAME	大喇叭	Đại Lạt Bá
E_STR_SIGN_IN	签到	Điểm danh
E_STR_BU_QIAN	补签	Điểm danh bổ sung
E_STR_ADD_UP_AWARD	累计%d日奖励	Phần thưởng tích lũy %d ngày
E_STR_DAY	%日	% ngày
E_STR_SIGN_IN_SUCCEED	签到成功！	Điểm danh thành công !
E_STR_GET_AWARD_SUCCEED	领取奖励成功！	Nhận phần thưởng thành công !
E_STR_SOME_DAY	连续签到%d日奖励	Phần thưởng liên tục điểm danh %d ngày
E_STR_REPAIR_SIGNIG	花费%d元宝补签，当前元宝不足	Dùng %d KNB điểm danh bổ sung, hiện tại KNB không đủ 
E_STR_DRESS_SUCCEED	穿戴成功	Trang bị thành công
E_STR_IMPOSE_GOLD	征收%d金币	Thu thuế được %d Vàng 
E_STR_IMPOSE_FOOD	征收%d粮草	Thu hoạch được %d Lúa 
E_STR_REFRESH_SUCCEED	刷新成功	Làm mới thành công
E_STR_TRAIN_SUCCEED	训练成功	Huấn luyện thành công
E_STR_SPEED_TRAIN_SUCCEED	加速训练成功	Tăng tốc huấn luyện thành công
E_STR_COMPOUND_SUCCEED	合成成功	Ghép thành công 
E_STR_UPGRADE_SUCCEED	升级成功	Tăng cấp thành công
E_STR_SOME_LEVEL_OPEN	武将等级%d级开启	Cấp Võ Tướng tăng %d cấp mở 
E_STR_YET_CATCH	此人已被你抓捕	Người này đã bị ngươi bắt giữ 
E_STR_GET_SUCCEED	领取成功	Nhận thành công
E_STR_CLICK_INPUT_CHAT	点击输入聊天内容	Ấn nhập nội dung chat
E_STR_CLICK_INPUT_ACCOUNTS	点击输入帐号	Ấn nhập tài khoản
E_STR_CLICK_INPUT_PASSWORD	点击输入密码	Ấn nhập mật khẩu
E_STR_CLICK_INPUT_PASSWORD_AGAIN	再次输入密码	Nhập mật khẩu lần nữa
E_STR_LEGION_BUILDING	军团建设中，敬请期待！	Quân Đoàn đang xây dựng, hãy theo dõi nhé !
E_STR_OPEN_SUCCEED	开启成功	Mở thành công
E_STR_STRENGTHEN_SUCCEED	强化成功	Cường hóa thành công
E_STR_REBUILD_SUCCEED	打造成功	Luyện thành công 
E_STR_BUY_SUCCEED	购买成功	Mua thành công
E_STR_SELL_SUCCEED	出售成功	Bán thành công
E_STR_GET_SOUL	获得%d将魂	Nhận được %d Tướng Hồn
E_STR_EXCHANGE_SUCCEED	兑换成功	Đổi thành công
E_STR_FUN_ITERATION	功能迭代中	Chức năng đang cập nhật
E_STR_DROP_EQUIP	成功脱下	Đã tháo trang bị
E_STR_GROW_FAIL	培养失败	Bồi dưỡng thất bại
E_STR_GROW_SUCCEED	培养成功	Bồi dưỡng thành công
E_STR_REBUILD_FAILS	打造失败	Luyện thất bại 
E_STR_WEAR_SOLDIER_PHYSICAL	穿戴兵种：刀，枪，骑	Trang bị: Đao, Thương, Kỵ
E_STR_WEAR_SOLDIER_MAGIC	穿戴兵种：谋，红	Trang bị: Mưu, Vũ
E_STR_WEAR_SOLDIER_ALL	穿戴兵种：全兵种	Trang bị: tất cả
E_STR_SWAP_EQUIP	更换	Đổi 
E_STR_WEAR_EQUIP	穿戴	Trang bị
E_STR_RETURN_INVALID_VALUE	未知错误,请重新登录!	Lỗi chưa xác định, thử đăng nhập lại !
E_STR_SET_NAME_CHONG_MING	服务器已有重名玩家	Server đã có người chơi trùng tên
E_STR_SET_NAME_INVALID_WORD	姓名中包含非法字符	Trong tên có ký tự đặc biệt
E_STR_SET_NAME_SUCC	取名成功	Đặt tên thành công
E_STR_SET_NAME	请输入名字	Mời nhập tên
E_STR_NET_RECONNECTION	主公！网络不给力啊，请重新连接	Chủ Công ! Mạng không ổn định, mời kết nối lại 
E_STR_NET_RELOGIN	你的账号异地登陆	Tài khoản của ngươi đăng nhập nơi khác 
E_STR_NAME_TOO_LENG	用户名不能超过7个字	Tên không được vượt quá 14 kí tự
E_STR_NAME_EMPTY	用户名不能为空	Tên không được để trống
E_STR_RES_NOT_USE	该物品无法使用	Vật phẩm này không thể sử dụng
E_STR_DIAO_CHAN	小蝉	Điêu Thuyền
E_STR_NOT_OPEN_BOSS	尚未开启	Chưa mở
E_STR_OPEN_BOSS	通关”%s”后开启”%s”	Thông quan “%s” mở “%s”
E_STR_CHALLENGE_BOSS	挑战	Khiêu chiến
E_STR_FOOD	粮食	Lúa 
E_STR_BANDIT	土匪	Thổ Phỉ
E_STR_TASK_LIMIT	君主等级未达到任务前往等级	Cấp Quân Chủ chưa đủ cấp nhiệm vụ tiếp theo 
E_STR_NO_ACTIVITY	亲~目前还没有活动哦	Thân ~ Hiện tại vẫn chưa có sự kiện nhé
E_STR_NO_ACTIVITY_AGAIN	亲...再点也没有活动的哦..	Thân…Vào nữa cũng chưa có sự kiện gì đâu nhé..
E_STR_NO_ACTIVITY_AGAIN_TOO	猛戳还是没有活动的哦..	Mãnh trạc vào nữa cũng có sự kiện gì đâu nhé..
E_STR_AGAIN_TOO_TOO	再戳!删号了啊!!!	Trạc lần nữa ! Xóa đấy nhé !!!
5104	是否需要花费%d元宝进行补签!	Dùng %d KNB tiến hành điểm danh bổ sung ! 
5110	得到%s%d	Nhận %s %d
E_STR_GAIN_ANYTHING	得到%s	Nhận %s
E_STR_GAIN_CASH	得到金币%d	Nhận %d Vàng 
E_STR_GAIN_HONNR	得到军功%d	Nhận %d Quân Công 
E_STR_NOT_OPEN_BY_LEVEL	尚未到达开启等级	Chưa đạt đến cấp để mở
E_STR_CHATINPUTISEMPTY	输入为空，请重新输入	Nhập để trống, mời nhập lại lần nữa 
E_STR_SKILL_BOOK_ROBED_MERGE_FAIL	你的残卷刚刚被抢夺了，合成失败	Tàn Quyển của ngươi vừa bị cướp mất rồi, ghép thất bại 
E_STR_EMBATTLE_SUCCESS	布阵成功	Bố trận thành công
E_STR_MAP_ENOUGH	图纸不足，是否前往获取？	Bản Vẽ không đủ, đồng ý lên trước để nhận ?
E_STR_NO_BUY_COUNT	今日元宝购买次数已用完，请明天再来	Đã dùng hết số lần mua KNB hôm nay, mời ngày mai quay lại 
E_STR_ARENA_REFRESH_DATA	擂台数据已更新，请重新选择对手进行挑战	Đã cập nhật dữ liệu Lôi Đài, mời chọn lại đối thủ tiến hành khiêu chiến 
E_STR_REWARD_SUCCEED	领取成功	Nhận thành công
E_STR_ARENA_INVALID_PAGE	亲，字符非法或超出最大页码了哦	Thân, đã chứa ký tự đặc biệt hoặc đã vượt số ký tự tối đa
E_STR_INPUT_NAME	请输入账号	Hãy nhập tài khoản
need_fight_prev_stage	必须通关上一个关卡!	Cần phải thông quan quan ải trước đó
count_zero	今日殴打次数用完了!明天再来吧!	Đã dùng hết số lần ẩu đả hôm nay ! Ngày mai quay lại nhé !
E_STR_RESCUE_POINT_FORMAT	前往%s击败%s后获得	Nhận được sau khi lên trước %s đánh bại %s
hero_altar_no_open	兄台,英雄祭坛你还没解锁呢啊!	Huynh đài, Anh Hùng Tế Đàn vẫn chưa mở mà !
E_STR_EQUIP_MAX	已达最高品阶	Đã đạt phẩm giới cao nhất
E_STR_ALREADY_RETREAT	玩家已撤军，无法抢夺	Người chơi đã rút quân, không thể cướp 
E_STR_RESET_CASH_ENOUGH	重置需要消耗%d元宝，当前元宝不足	Làm mới cần dùng %d KNB, hiện tại KNB không đủ 
E_STR_AUTO_CHALLENGE_CASH_ENOUGH	本次自动战斗需要花费%d元宝，当前元宝不足	Lần tự động khiêu chiến này cần dùng %d KNB, hiện tại KNB không đủ 
E_STR_ARENA_CASH_ENOUCH	本次挑战需要花费%d元宝，当前元宝不足	Khiêu chiến cần %d KNB, hiện tại KNB không đủ
E_STR_GOLDMINE_FULL	（满）	(Đầy)
E_STR_NOT_ROB	已拥有此残卷，无法抢夺	Đã sở hữu Tàn Quyển này, không thể cướp 
E_STR_NO_FRAGMENT_TO_ROB	该玩家的残卷已被他人抢走	Tàn Quyển của người chơi này đã bị người khác cướp 
E_STR_KEEP_MINE_SUCCESS_AND_FULL	胆敢掠夺你的金矿，被你打败！你的金矿已经满了！	Cả gan dám cướp Ngân Khoáng của ngươi, bị ngươi đánh bại! Ngân Khoáng của ngươi đầy rồi!
E_STR_CLICK_BUY	点击购买	Ấn để mua
E_STR_ARENA_CONDITION_NOT_REACH	条件未达到	Chưa đạt 
E_STR_ARENA_CURR_EXP	当前经验：%d	Exp hiện tại: %d 
E_STR_ARENA_UP_EXP	升级经验：%d	Exp tăng cấp: %d
E_STR_ARENA_EXP_NAME	擂台经验	Exp Lôi Đài 
E_STR_OPEN_THOUSAND	需要先开启”勇闯重楼“	Cần mở “Thiên Trọng Lâu” trước
E_STR_GOLDMINE_FAIL	金矿掠夺失败，你损失了%d金币	Ngân Khoáng cướp thất bại, ngươi đã tổn thất %d Vàng 
E_STR_BUSINESS_OPEN_LEVEL	君主等级%d级开启镖局	Quân Chủ cấp %d mở Tiêu Cục 
E_STR_BUSINESS_TIMES_OVER	商队过于疲劳，请稍事休息后再前进。	Đội buôn đã quá kiệt sức, hãy nghĩ ngơi tí rồi đi tiếp
E_STR_HOUR_FOOD	每间隔一段时间产出粮食	Mỗi quảng thời gian được Lúa
E_STR_HOUR_GOLD	每间隔一段时间产出金币	Mỗi quảng thời gian được Vàng 
charllenge_level_limit	请提升等级至%d,再来挑战吧!	Hãy tăng đến cấp %d, rồi quay lại khiêu chiến nhé !
E_BAG_SHOP_UNIT_PRICE	单价	Giá
E_BAG_SHOP_BUY_BUTTON	购买	Mua
E_BAG_SHOP_SELL_BUTTON	出售	Bán
E_BAG_SHOP_USE_BUTTON	使用	Sử dụng
E_BAG_SHOP_SOUL_BUTTON	化魂	Hóa hồn
E_STR_FIGHT_LIMIT	君主等级达到%d级可挑战	Quân Chủ đạt đến cấp %d có thể khiêu chiến 
E_STR_TAVERN_FULL	招贤馆已满，请一键送客	Tửu Quán đã đầy, ấn để tiễn hết khách
E_STR_ROLE_LIMIT	君主等级%d级可增加一个栏位	Quân Chủ cấp %d có thể mở thêm 1 ô
E_STR_ROLE_LIMIT_MAX	栏位已达到最大值	Ô đã đầy
EXP_EFFECT_CUR	当前:%d	Hiện tại: %d
EXP_EFFECT_REMAIN	剩余:%d	Còn lại: %d
EXP_EFFECT_Percent	%0.2f%%	%0.2f%%
buy_food_count_limit	今日元宝购买次数已用完，VIP可获得额外购买次数	Đã sử dụng hết số lần mua KNB hôm nay, VIP có thể thêm số lần mua
E_STR_ROLE_FULL	%d/%d已满	%d/%d đã đầy
E_STR_ACTIVE_INFO	当前活跃度%d,再增加%d可领取宝箱！	Hiện tại là %d, tăng thêm %d có thể nhận Bảo Rương!
E_STR_ACTIVE_FULL	主公！你今日活跃度已完成，请明日再来！	Chủ Công! Độ hoạt động hôm nay đã hoàn thành, mời ngày mai quay lại! 
E_STR_YOUR_GAIN_FOOD	你获得了%d粮草	Bạn nhận được %d Lúa 
E_STR_YOUR_GAIN_MATERIAL	获得%d个%s	Nhận %d %s
E_STR_FOOD_NAME	粮草	Lúa 
E_STR_HONOR_NAME	军功	Quân Công 
E_STR_THOUSANDFOOLR_WAR	本次重楼挑战共收获	Tổng thu hoạch
E_STR_THROUGHTHETRIALS_WAR	本次过关斩将挑战共收获	Thu hoạch được trong Quá Quan Trảm Tướng lần này
E_ALREADY_SAVED_THIS_ONE	该美人已解救，是否前去查看？	Đã giải cứu mỹ nhân này, đi xem ?
E_SYMBOL_VERY_BIG	∞	∞
E_STR_ELITE_HERO	精英武将	Võ Tướng Tinh Anh 
E_STR_ELITE_SOLDIER	精英士兵	Sĩ Binh Tinh Anh 
E_STR_GOTO_LIMIT	君主等级%d级可前往	Quân Chủ cấp %d có thể lên trước 
CongratsOnGirlSaved	恭喜你成功解救%s	Chúc mừng ngươi đã thành công giải cứu %s
E_STR_EMBATTLE_FULL	上阵人数已满	Võ Tướng xuất trận đã đầy 
E_STR_PROTECT_DAY	%d/5天	%d/5 ngày
E_STR_DRIVE	驱赶	Xua đuổi
E_STR_GET_AWARD	领取奖励	Nhận
E_STR_MYSTICAL	神秘奖励	Quà thần bí
E_STR_BS_CONFIRM_HAS_NUM	当前已有数量：%d	Hiện tại có: %d
E_STR_BS_CONFIRM_HAS_NUM_STR	当前已有数量：%s	Hiện tại có: %s
E_STR_HERO_NO_OPEN	英雄尚未解锁	Anh hùng chưa mở
E_STR_BS_GET_ROLE_SUCCESS	获得武将	Nhận được Võ Tướng 
E_STR_ACTIVE_NAME	%d活跃度宝箱	%d độ hoạt động Bảo Rương 
E_STR_TREASURE_GOBACK	返回起点将减少一次探宝次数，是否继续？	Quay lại khởi điểm sẽ giảm một lần thám bảo, đồng ý tiếp tục ?
E_STR_TREASURE_DOAGAIN	主公！是否花费%d元宝重新翻牌一次？	Chủ Công ! Đồng ý dùng %d KNB làm mới một lần lật bài ?
E_STR_TREASURE_GONEXT	前进	Lên trước
E_STR_TREASURE_AUTOGO	机选四次	Máy chọn 4 lần
E_STR_TREASURE_RIFFLE	洗牌(%d秒)	Tẩy bài (%d giây)
E_STR_TREASURE_CANGONEXT	发现%s	Phát hiện %s
E_STR_TREASURE_HAVENOCOUNT	次数不足	Số lần không đủ
E_STR_TREASURE_LIMITCOUNT	当前探宝次数不足！	Hiện tại số lần thám bảo không đủ !
E_STR_TREASURE_HAVENOOPEN	你还没有开启下一章节探索宝箱！	Bạn vẫn chưa mở chương kế tiếp thám tác Bảo Rương !
E_STR_TREASURE_GOBACKBTN	返回起点	Quay lại khởi điểm
E_STR_TREASURE_COUNT	今日剩余挖矿次数%d/%d	Số lần chiếm hôm nay còn: %d/%d
E_STR_TREASURE_CANNOTOPEN	请先开启上一章节探索宝箱！	Hãy mở chương kế thám tác Bảo Rương ! 
E_STR_TREASURE_GOLDLLIMT	开启需要%d金币，当前金币不足	Mở cần %d Vàng, hiện tại Vàng không đủ 
E_STR_TREASURE_UPTIME	后恢复一次.	Sau hồi phục 1 lần
E_STR_TREASURE_ALLAWARD	本次探宝共收获	Thu hoạch được trong thám tác Bảo Rương lần này
E_STR_SET_NAME_INVALID_TYPE	你输入的文字只能为数字、英文、汉字	Bạn chỉ có thể nhập chữ và số
E_STR_BEAUTY_RESCUE_POINT_LABEL	通关“%s”副本后开启	Thông quan “%s” Phụ Bản mở
E_STR_CANJUAN_NULL	今日残卷合成次数已用完，请明天再来！	Đã dùng hết số lần ghép Tàn Quyển hôm nay, mời ngày mai quay lại !
E_STR_SPEND_PRISON_END	花费%d元宝加速，直接获得%d金币，并释放%s，确定加速吗？	Dùng %d KNB để tăng tốc, nhận ngay %d Vàng, và phóng thích %s, đồng ý tăng tốc ?
E_STR_TREASURE_TIMEINFO	剩余探宝次数	Số lần thám bảo còn lại
E_STR_SOON	贼兵即将偷袭汉献帝	Binh tặc sắp tập kích Hán Hiến Đế
E_STR_SAFE	暂时安全	Tạm thời an toàn
E_STR_TREASURE_HAVENOCASH	本次重置需要%d元宝，当前元宝不足！	Lần làm mới này cần %d KNB, hiện tại KNB không đủ !
E_STR_GOLDMINE_WANGZHE	王者金矿	Vương giả Ngân Khoáng 
E_STR_GOLDMINE_GUIZU	贵族金矿	Quý tộc Ngân Khoáng 
E_STR_GOLDMINE_FURAO	富饶金矿	Phú nhiêu Ngân Khoáng 
E_STR_GOLDMINE_PINGMIN	平民金矿	Bình dân Ngân Khoáng 
E_STR_GOLDMINE_NANMIN	难民金矿	Nạn dân Ngân Khoáng
E_STR_GOLDMINE_LV	Lv%d-Lv%d	Lv%d - Lv%d
E_STR_REP_ENOUGH	主公！声望不够啊!	Chủ Công ! Danh Vọng không đủ rồi !
E_STR_GOLDMINE_BIG_LV	%d级以上	Cấp %d trở lên 
E_STR_EXP	%d经验	%d Exp 
E_STR_BEAUTY_UPGRADE	升级	Tăng cấp
E_STR_BEAUTY_ALREADY_MAX	已经满级	Đã đầy cấp
E_STR_NOT_ENOUGH_STARS	主公！通关新的副本可获得星星！	Chủ Công ! Thông quan Phụ Bản mới sẽ nhận được Sao !
E_STR_ATTR_BRACKET_MAX	(满级)	(Đầy cấp)
E_STR_GEM_COUNT_INVALID	非法字符，请输入数字	Ký tự đặc biệt, mời nhập số
E_STR_CARD_SHUFFLE_BTN	洗牌	Tẩy bài
E_STR_CARD_FIGHT_BTN	开战	Chiến 
E_STR_BUY_FOOD_LIMIT	君主等级%d级可购买粮草	Chủ Công cấp %d có thể mua Lúa 
E_STR_GEM_NOT_ENOUGH_AND_BUY	所需%s不足，是否前去购买。	%s không đủ, đi mua.
E_STR_GOLDMINE_NOT_FIGHT	玩家还在保护时间内，不能抢夺	Người chơi vẫn đang trong thời gian bảo vệ, không thể cướp 
E_STR_PLEASE_GET_PREVIOUS_CHAPTER_PASSED	请解锁美人开启战斗任务	Hãy mở khóa mỹ nhân bắt đầu nhiệm vụ chiến đấu
E_STR_FIRE_ROLE_TO_BAG	成功解雇武将，武将卡牌进入背包	Thành công sa thải Võ Tướng, thẻ Võ Tướng vào túi 
E_STR_BAG_TO_CALL	召唤	Triệu hồi
E_STR_BAG_TO_COMBINE	合成	Ghép
E_STR_USE_EXP_INFO	使用%d个经验丹就能使%s武将等级达到君主等级	Sử dụng %d Exp đan tăng %s cấp Võ Tướng đạt đến cấp Quân Chủ 
E_STR_REP	声望	Danh Vọng 
E_STR_CHIP_NOT_ENOUGH	碎片不足，%d个%s碎片可以合成%s	Không đủ, %d %s có thể ghép %s
E_STR_ALLROLE_attack	全体上阵武将武力增加%d	Võ Lực toàn thể Võ Tướng xuất trận tăng %d
E_STR_ALLROLE_defence	全体上阵武将武防增加%d	Võ Phòng toàn thể Võ Tướng xuất trận tăng %d
E_STR_ALLROLE_mdefence	全体上阵武将谋防增加%d	Mưu Phòng toàn thể Võ Tướng xuất trận tăng %d
E_STR_ALLROLE_miss	全体上阵武将闪避增加%d	Né Tránh toàn thể Võ Tướng xuất trận tăng %d
E_STR_ALLROLE_block	全体上阵武将格挡增加%d	Đỡ toàn thể Võ Tướng xuất trận tăng %d
E_STR_ALLROLE_critdamage	全体上阵武将暴击增加%d	Bạo Kích toàn thể Võ Tướng xuất trận tăng %d
E_STR_YOU_HAVE_NOT_ENOUGH_GOLD_TO_DESPOIL	你的赔偿金不足%d金币，无法掠夺！	Bồi thường Vàng của ngươi không đủ %d Vàng, không thể cướp !
E_STR_DESPOIL_SUCCESS	掠夺成功！您得到%d金币！	Cướp thành công ! Ngươi nhận được %d Vàng ! 
E_STR_DESPOIL_FAILURE	掠夺失败！您失去了%d金币！	Cướp thất bại ! Ngươi đã mất đi %d Vàng !
E_STR_HONOR_NOT_ENOUGH	军功不足	Quân Công không đủ 
E_STR_NOT_ENOUGH_GOLD	金币不足	Vàng không đủ
E_STR_CASH_NOT_ENOUGH	元宝不足	KNB không đủ 
E_STR_REP_NOT_ENOUGH	声望不足	Danh Vọng không đủ 
E_STR_FOOD_NOT_ENOUGH	粮草不足	Lúa không đủ 
E_STR_STARS_NOT_ENOUGH	星星不足	Sao không đủ
E_STR_SPEND_CASH_FOR_CAPTURE	确认花费%d元宝占领金矿？	Dùng %d KNB chiếm Ngân Khoáng ?
E_STR_SPEND_CASH_FOR_DESPOIL	确认花费%d元宝掠夺金矿？	Dùng %d KNB cướp Ngân Khoáng ?
E_STR_SPEND_NO_CASH_FOR_CAPTURE	少侠！元宝不足，无法购买占领次数！	KNB không đủ, không thể mua số lần chiếm Ngân Khoáng !
E_STR_SPEND_NO_CASH_FOR_DESPOIL	少侠！元宝不足，无法购买掠夺次数！	KNB không đủ, không thể mua số lần cướp Ngân Khoáng !
E_STR_GOLDMINE_DISTRICT	%s（%d区）	%s  (Server %d)
E_STR_GOLDMINE_DISTRICT_1	（一区）	(Server 1)
E_STR_GOLDMINE_DISTRICT_2	（二区）	(Server 2)
E_STR_GOLDMINE_DISTRICT_3	（三区）	(Server 3)
E_STR_GOLDMINE_DISTRICT_4	（四区）	(Server 4)
E_STR_GOLDMINE_DISTRICT_5	（五区）	(Server 5)
E_STR_GOLDMINE_DISTRICT_6	（六区）	(Server 6)
E_STR_GOLDMINE_DISTRICT_7	（七区）	(Server 7)
E_STR_GOLDMINE_DISTRICT_8	（八区）	(Server 8)
E_STR_GOLDMINE_DISTRICT_9	（九区）	(Server 9)
E_STR_GOLDMINE_DISTRICT_10	（十区）	(Server 10)
E_STR_THIS_GOLDMINE_IS_WARFREE	此座金矿当前免战	Hiện tại miễn chiến Ngân Khoáng này 
E_STR_EMPTY_GOLDMINE	无人占领	Vô chủ 
E_STR_GOLDMINE_HAVE_BEEN_CAPTURED_AHEAD	此座金矿已被人抢先占领!	Ngân Khoáng đã bị chiếm trước rồi !
E_STR_GOLDMINE_HAVE_BEEN_LEFT_AHEAD	此座金矿已被撤军！（无法完成掠夺）	Ngân Khoáng đã bị rút quân ! (không thể hoàn thành cướp)
E_STR_OCCUPY_FAILDED_NO_PIT	无空余矿坑，占领金矿失败	Không có Ngân Khoáng trống, chiếm Ngân Khoáng thất bại 
E_STR_OCCUPY_ACTION_FAILED	占领/掠夺/随机占领失败	Chiếm/Cướp/Tùy cơ chiếm thất bại 
E_STR_LEAVE_ACTION_FAILED	撤军失败	Rút quân thất bại
E_STR_MATERIAL_MAX	道具已达最高级，更高等级敬请期待！	Vật phẩm đã đạt cấp cao nhất, cấp cao hơn xin hãy chờ nhé !
E_STR_SPEND_CASH_TO_REPICK_CARD	是否花费%d元宝重新选牌？	Đồng ý dùng %d KNB chọn lại bài khác?
E_STR_REPICK_CARD_NO_CASH	重新选牌需要%元宝，当前元宝不足	Chọn lại bài khác cần % KNB, hiện tại KNB không đủ
E_STR_NO_FOSTER	您当前没有培养丹	Hiện tại ngươi không có Linh Đan 
E_STR_CHAT_LEGION_CHAT_NOT_30_WORD	亲，聊天汉字不能超过%d个哦	Thân, nội dung chat không được vượt quá %d từ nhé
E_STR_CARD_MASTER_WIN	胜+1	Thắng +1
E_STR_CARD_MASTER_LOSE	败+1	Bại +1
E_STR_CARD_MASTER_DRAW	平+1	Hòa +1
E_STR_CARD_MASTER_NOT_ENOUGH_CARD	请选择五张卡牌进行战斗	Hãy chọn 5 thẻ tiến hành chiến đấu
E_STR_CARD_MASTER_NO_CASH_COUNT	今日元宝刷新次数已用完，请明天再来	Đã dùng hết số lần KNB làm mới hôm nay, mời ngày mai quay lại 
E_EXCHANGE_MATERIAL_NO_ENOUGH	%s不足	%s không đủ
E_STR_COIN_NOT_ENOUGH	古币不足	Tiền Cổ không đủ 
E_STR_MOPUP_COOL_TIME	扫荡冷却时间	Thời gian chờ càn quét 
E_STR_CARD_MASTER_NOT_ENOUGH_SCORE	积分不够	Điểm không đủ
E_STR_BAG_SHOP_EXCHANGE_STR	兑换	Đổi
E_STR_GAIN_MATERIAL	得到%sX%d	Nhận được %s X %d
E_STR_ACHIEVEMENT_CHEST	%d级成就宝箱	Nhiệm Vụ Bảo Rương cấp %d
E_STR_GAIN_RES	获得%d%s	Nhận được %d %s
E_STR_FINISH	已完成	Đã hoàn thành
E_STR_INDENT_FINISH	订单素材已满，请返回订单界面。	Vật liệu nhiệm vụ đã đầy, mời quay lại giao diện nhiệm vụ. 
E_STR_INDENT	订单%d	Nhiệm vụ %d
E_STR_MOPUP_ALLAWARD	本次获得以下材料	Lần này nhận được vật liệu dưới đây
E_STR_MAX_LIMIT_INFO	当前已达最高级	Đầy cấp
E_STR_FOOD_DESC	人是铁，饭是钢，一顿不吃饿的慌！要打胜仗还是多屯粮吧！	Người là thiết, cơm là thép, một bữa không ăn đói đến kinh hoàng! Muốn đánh thắng trận hãy trữ thêm lương nhé !
E_STR_PAWN_GO_LIMIT	前进次数耗尽，请休息一会再来	Số lần lên trước đã hết, hãy nghỉ ngơi một lúc rồi quay lại
E_STR_PAWN_MATERIAL_FULL	%s%d/%d（完成）	%s%d/%d (hoàn thành)
E_STR_SOULELITEFB_TIMES_OVER	将令不足！	Tướng Lệnh không đủ !
E_STR_HONORELITEFB_TIMES_OVER	兵令不足！	Binh Lệnh không đủ !
E_STR_ADDITION_SOULXP	每张增加经验：%d	Mỗi tấm tăng Exp: %d
E_STR_CONTINUE_SOLICIT	继续招募	Tiếp tục
E_STR_CONTINUE_EXCHANGE	继续兑换	Tiếp tục đổi
E_STR_OPEN_SPEED	君主等级%d级开启加速战斗	Quân Chủ cấp %d mở tăng tốc chiến đấu 
E_STR_OPEN_SKIP	君主等级%d级开启跳过战斗	Quân Chủ cấp %d mở bỏ qua chiến đấu 
E_STR_FIRST_OPEN_SKIP	只有挑战成功的关卡才能跳过战斗	Chưa vượt ải này, không thể bỏ qua chiến đấu
E_STR_REFRESH_PANEL	换一批	Đổi
E_STR_ONE_HUNDRED_MILLION	%d亿	%d Ức
E_STR_BS_CONFIRM_HAS_NUM_FOOD	已有数量：%s	Hiện có: %s
E_STR_SOULEXP_OVER	炼魂经验超过上限%d，是否继续？	Exp luyện hồn vượt quá giới hạn %d, đồng ý tiếp tục ?
E_STR_BAG_SHOP_CANNOT_SELL	无法出售	Không thể bán
E_STR_COIN	古币	Tiền Cổ
E_STR_NO_FOSTER_AND_GO_TO_SHOP	培养丹不足，是否前往购买？	Linh Đan không đủ, đi mua ?
E_STR_YET_BUY	已购买	Đã mua
E_STR_YOUR_GAIN_REP	你获得了%d声望	Bạn nhận được %d Danh Vọng 
E_STR_OPEN_BOX_INFO	开启%d个%s需要%d个%s，您是否开启？	Mở %d cái %s cần %d cái %s, ngươi đồng ý mở ?
E_STR_OPEN_BOX_KEY_ENOUGH	您只有%d把%s，还差%d把。当背包中没有%s时，点击使用%s可购买%s。	Bạn chỉ có %d cái %s, còn thiếu %d cái %s. Khi trong túi không có %s, ấn sử dụng %s có thể mua %s.
E_STR_SOLICIT_SURE_RED	本次招募必出血將	Lần chiêu mộ này sẽ ra Huyết Tướng 
E_STR_SOLICIT_REMAIN_RED	再招%d次必出血將	Chiêu thêm %d lần chắc chắn ra Huyết Tướng
E_STR_NEED_KEY	需要%d把%s，是否前去购买？	Cần %d cái %s, đi mua ?
E_STR_ROLE_CANNOT_KILL	已召唤的武将被解雇后方可分解	Có thể phân giải Võ Tướng bị sa thải
E_SOUL_NUM_1	%d	%d
E_SOUL_NUM_2	/%d	/%d
E_STR_GEM_NOT_ENOUGH_BUSINESS	所需%s不足，是否前往镖局。	%s không đủ, đi tiêu cục.
E_STR_PAWN_WAR_INFO	战斗获胜可获得敌人所携带的物品	Chiến thắng có thể nhận được các vật phẩm của địch
E_STR_PAWN_BUSINESS_INFO	若选择“放弃”，则不会获得，也不会损失	Nếu chọn “từ bỏ”, thì sẽ không nhận được, cũng sẽ không tổn thất
E_STR_BAG_PROTECTEDNUM	已达到背包保护上限	Túi đã đạt đến giới hạn bảo vệ
E_STR_PLEASE_RE_UPDATE	更新失败，请重新更新	Cập nhật thất bại, hãy cập nhật lại
E_STR_FIGHT_ADVANCE	战力提升	Nâng cao lực chiến
E_STR_ORANGE_NOT_BLUE	橙将不能传承蓝将	Kim Tướng không thể truyền thừa Lam Tướng 
E_STR_ORANGE_NOT_PURPLE	橙将不能传承紫将	Kim Tướng không thể truyền thừa Tử Tướng 
E_STR_RED_NOT_BLUE	血将不能传承蓝将	Huyết Tướng không thể truyền thừa Lam Tướng 
E_STR_RED_NOT_PURPLE	血将不能传承紫将	Huyết Tướng không thể truyền thừa Tử Tướng 
confirm_split	当前武将中有血将，你是否需要全部拆解？	Có Huyết Tướng, ngươi đồng ý bỏ tất cả ?
E_STR_ALLROLE_health	全体上阵武将兵力增加%d	Binh Lực toàn thể Võ Tướng xuất trận tăng %d
E_STR_UPDATE_TARGET_VERSION	更新目标版本%s	Cập nhật phiên bản %s
E_STR_UPDATE_TARGET_VOLUME_BYTE	更新档案大小%d Bytes	Cập nhật %d Bytes
E_STR_UPDATE_TARGET_VOLUME_KB	更新档案大小%.1f KB	Cập nhật %.1f KB
E_STR_UPDATE_TARGET_VOLUME_MB	更新档案大小%.1f MB	Cập nhật %.1f MB
E_STR_TOKEN_ERROR	链接超时，请重新登录	Lỗi liên kết, hãy đăng nhập lại
E_STR_CDKEY_NOT_EXIST	礼包码不正确，请重新输入	Mã Giftcode không chính xác, hãy nhập lại
E_STR_CDKEY_USED	礼包码已被使用，请重新输入	Mã Giftcode đã được sử dụng, hãy nhập lại
E_STR_PROTECT_END	今日追兵已被消灭	Hôm nay truy binh đã bị tiêu diệt
E_STR_DAO_ATTR_ADD	刀兵属性加成	Thêm vào thuộc tính Đao Binh 
E_STR_QIANG_ATTR_ADD	枪兵属性加成	Thêm vào thuộc tính Thương Binh
E_STR_QI_ATTR_ADD	骑兵属性加成	Thêm vào thuộc tính Kỵ Binh
E_STR_MO_ATTR_ADD	谋士属性加成	Thêm vào thuộc tính Mưu Sĩ 
E_STR_HONG_ATTR_ADD	红颜属性加成	Thêm vào thuộc tính Vũ Cơ 
E_STR_GEM_OPEN_LV	强化%d级开启	Cường hóa cấp %d mở
E_STR_FOSTER_COMBINE	培养丹合成	Ghép Linh Đan 
E_STR_TIPS_SELECT_A_CARD	请选择一张卡牌	Hãy chọn 1 tấm thẻ
E_STR_TIPS_FREE_COUNT_REFRESH_CARDS	本次换牌免费	Lần đổi bài này miễn phí
E_STR_SKILL_OPEN_LV	%d级开启	Cấp %d mở
E_STR_YOUR_GAIN_CASH	你获得了%d元宝	Bạn nhận được %d KNB
transfer_card_need	(卡)	(thẻ)
E_STR_SHOP_CONFIRM_BUY_TITLE	确认购买	Mua
E_STR_SHOP_CONFIRM_SELL_TITLE	确认出售	Bán
E_STR_SHOP_CONFIRM_SOUL_TITLE	确认化魂	Hóa Hồn
E_STR_SHOP_CONFIRM_USE_TITLE	确认使用	Sử Dụng
E_STR_SELECT_ROLE	选择武将	Chọn Võ Tướng 
E_STR_SELECT_EQUIP	选择装备	Chọn
E_STR_SELECT_MATERIAL	素材兑换	Đổi vật liệu
E_STR_SELECT_ROB	掠夺	Cướp 
E_STR_TODAY_GOLD_TIMES	今日可免费占领或掠夺金矿次数	Số lần chiếm/cướp hôm nay còn:
E_STR_GIRL_OPEN_LIMIT	通关“兖州”副本后开启	Sau khi thông quan Phụ Bản “Duyện Châu” mở 
E_STR_ACTIVITY_UNLOCK_DESC	%d级解锁	Cấp %d mở khóa
hero_altar	英雄祭坛	Anh Hùng Tế Đàn
no_limit	无限制	Không giới hạn
E_STR_CDKEY_INFO	请输入兑换码	Hãy nhập Giftcode
level	级	Cấp
E_STR_GETROLEOPENLELVEL	招贤馆%d级解锁	Tửu Quán cấp %d mở khóa 
E_STR_STRENGTH_OPENLEVEL	强化%d级解锁	Cường hóa cấp %d mở khóa
E_STR_THOUSANDFLOOR_DEC	突破%d层之后将开启扫荡，可快速上塔	Sau khi đột phá %d tầng sẽ mở càn quét, có thể lên tháp nhanh chóng
E_STR_UNLOCK_STAGE	请先解锁此关卡！	Hãy mở khóa quan ải này trước !
E_STR_BUG	BUG反馈及建议	Đề nghị và phản hồi BUG
E_STR_SYSTEM	系统设置	Liên hệ
E_STR_FEEDBACK_SENT	反馈已发送！	Phản hồi đã gửi đi !
E_STR_NOT_ENOUGH_ROLE_CARD_IN_BAG	背包武将卡不足！	Túi thẻ Võ Tướng không đủ !
E_STR_VIP_OPEN_LEVEL	VIP%d开启！	VIP %d mở !
LS_PRO_BUYFOOD	购买粮草次数	Số lần mua Lúa 
LS_PRO_OPENTRAINSEAT	开启训练位	Mở huấn luyện
LS_PRO_MAKEEQUIPADD	打造装备成功率	Tỉ lệ thành luyện trang bị 
LS_PRO_MINE_TAKE	购买占领金矿次数	Mua số lần chiếm Ngân Khoáng 
LS_PRO_ARENA_TAKE	购买擂台挑战次数	Mua số lần khiêu chiến Lôi Đài 
LS_PRO_TOWER_RESET	购买充值重楼次数	Mua số lần làm mới Thiên Trọng Lâu
LS_PRO_SYNSIS	技能书合成次数	Số lần ghép sách kỹ năng
LS_PRO_BUSINESS_STEP	商社行动能力上限	Khả năng đi lại thương xã tối đa
LS_PRO_CASH_APPEND	再充值%d元宝可升级至	Nạp thêm %d KNB có thể tăng đến cấp 
LS_PRO_PREVILEGE	VIP%d	VIP %d
LS_PRO_FULI	每日特购	Mua đặc biệt hằng ngày
LS_RMB_SYM	￥%d	%d VND
LS_NOT_OPEN_YET	未开启	Chưa mở
LS_BOUGHT_ALREADY	已经购买	Đã mua
LS_BOUGHT_ERROR	购买VIP道具失败	Mua vật phẩm VIP thất bại 
LS_BOUGHT_DONE	购买成功！	Mua thành công !
E_STR_GODROLE_GO_TO_FIGHT	前往征战	Tiến lên chinh chiến
E_STR_GET_GOD_ROLE	获得吕布	Nhận được Lữ Bố
E_STR_GET_GOD_DEC	已获得%d颗星星，再获得%d颗可获得%s	Đã nhận được %d sao, đạt thêm %d sao có thể nhận được %s
E_STR_GET_GOD_ROLE_LIMIT_ONE	活动%d天内将%s升级到%d级(%s)	Trong %d ngày tăng %s đến cấp %d(%s)
E_STR_GET_GOD_ROLE_LIMIT_TWO	活动%d天内将%s进阶到%d级兵种(%s)	Trong %d ngày tiến cấp %s đến cấp %d(%s)
E_STR_NOT_OPEN_GOD_ROLE	还未开启	Vẫn chưa mở
E_STR_FINISH_GOD_ROLE	即将达成	Sắp nhận được
E_STR_GET_CASH	领取元宝	Nhận KNB 
E_STR_GET_GOD_ROLE_FALIUE	已过期	Đã quá hạn
E_STR_AFTER_GET_GOD_ROLE_OPEN	获得%s后开启	Nhận được %s mở
E_STR_ROLE_LEVEL_NOT	武将等级还未达到%d级	Cấp Võ Tướng vẫn chưa đạt đến cấp %d
E_STR_SOLDIER_LEVEL_NOT	兵种等级还未到达%d级	Cấp binh chủng vẫn chưa đạt đến cấp %d
E_STR_CHALLENGE_TOWER_DESC	挑战重楼	Khiêu chiến Trọng Lâu
E_STR_GETAWARD_OVERTIME	领奖时间已过	Đã quá thời gian nhận
LS_IMMEDIATE_GOT_CASH	立获%d元宝	Nhận ngay %d KNB 
LS_CONTINUOUS_DAYS_CASH	连续%d天	Liên tục %d ngày
LS_RMB_MONTH_CARD_BUY	￥%d	%d VND
LS_CLAIM_REWARD	领取奖励	Nhận
LS_MONTH_CARD_NAME	月卡	Thẻ tháng
LS_VIP_ALREADY_MAX	VIP等级已达到最高	Cấp VIP đã đạt cao nhất
LS_MONTH_DAILY_ALREADY_ERROR	今日月卡奖励已领取！	Đã nhận phần thưởng thẻ tháng hôm nay !
LS_MONTH_CARD_BOUGHT_DONE	月卡购买成功！	Mua thẻ tháng thành công !
LS_MONTH_CARD_BOUGHT_ERROR	月卡购买失败，请与客服联系	Mua thẻ tháng thất bại, hãy liên hệ DVCSKH
LS_MONTH_DAILY_CLAIM_DONE	领取月卡奖励成功！	Nhận phần thưởng thẻ tháng thành công !
LS_MONTH_DAILY_CLAIM_ERROR	领取月卡奖励失败，请与客服	Nhận phần thưởng thẻ tháng thất bại, hãy liên hệ DVCSKH
LS_MONTH_DAYS_LEFT	月卡剩余%d天	Thẻ tháng còn lại %d ngày
E_STR_ARENA_NO_BUY_AND_VIP	您额外挑战次数为0，提升VIP等级可获得额外挑战次数。	Số lần khiêu chiến thêm của ngươi là 0, tăng cấp VIP có thể nhận thêm số lần khiêu chiến 
E_STR_ARENA_NO_BUY_COUNT	今日挑战次数已用完，请明日再来。	Đã dùng hết số lần khiêu chiến hôm nay, mời ngày mai quay lại.
E_STR_RESETTOWER_FREE_DESC	本次重置免费，重置后返回第一层（剩余免费重置：%d次）	Lần làm mới này miễn phí, sau khi làm mới quay lại tầng 1 (miễn phí làm mới còn lại: %d lần)
E_STR_NO_EXTR_RESETTIMES_DESC	您额外重置次数为0，提升VIP等级可获得额外重置次数。	Số lần làm mới thêm của ngươi là 0, tăng cấp VIP có thể nhận thêm số lần làm mới. 
E_STR_RESETTOWER_CASH_DESC	本次重置将花费%d元宝，重置后返回第一层（剩余额外重置：%d次）	Lần làm mới này dùng %d KNB, sau khi làm mới quay lại tầng 1 (làm mới thêm còn lại : %d lần)
E_STR_NO_RESETTIMES_TODAY_DESC	今日额外重置次数已用完，请明日再来。	Đã dùng hết số lần làm mới thêm hôm nay, mời ngày mai quay lại.
LS_CHARGE_MORE	再充值%d元宝即可成为	Nạp thêm %d KNB trở thành
LS_PICKUP_DAILY	每日领取%d元宝	Mỗi ngày nhận %d KNB
LS_PICKUP_DAILY2	每日%d元宝	Mỗi ngày %d KNB 
LS_PICKUP_INALL	总计领取%d元宝	Tổng nhận %d KNB
LS_CASH_NUM	%d元宝	%d KNB
LS_RMB_NUM	%d元	%d VND
LS_MONTH_CARD_CLICK_CLAIM	点击领取奖励	Ấn để nhận
LS_MONTH_CARD_PRICE_FMT	超级月卡%d元	Thẻ tháng siêu cấp %d VND
E_STR_DAY_NUM	%d天	%d ngày
E_STR_LOGIN_SUCC	登录成功，请重新启动游戏	Đăng nhập thành công, hãy khởi động lại trò chơi
E_STR_LOGIN_FAIL	登录失败，请重新启动游戏	Đăng nhập thất bại, hãy khởi động lại trò chơi
E_STR_GOD_ROLE_ING	进行中	Đang tiến hành
E_STR_GOD_ROLE_OVER	已完成	Đã hoàn thành
E_STR_TEMPLE_NO_REFRESH	保护时间内不可刷新	Trong thời gian bảo vệ không được làm mới
E_STR_SERVER_DOWN	(维护)	(Bảo vệ)
E_STR_ACCOUNT_ERROR_USER_NOT_EXISTS	用户名不存在	Tên đăng nhập không tồn tại
E_STR_ACCOUNT_ERROR_WRONG_PASSWD	用户名或密码错误	Sai tên đăng nhập hoặc mật khẩu
E_STR_ACCOUNT_ERROR_USER_ALREADY_EXISTS	该用户名已经存在	Tên đăng nhập này đã tồn tại
E_STR_ACCOUNT_ERROR_PASSWORD_NOT_MATCH	两次输入的密码不一致	Hai lần nhập mật khẩu không giống nhau
E_STR_ACCOUNT_ERROR_INPUT_NAME_OR_PASS	请输入完整的账户信息	Hãy nhập hoàn chỉnh thông tin tài khoản
E_STR_EXSOUL_HASRED_PROMPT	当前炼魂有彩将卡，是否确认炼魂？	Hiện tại luyện hồn có thẻ Thần Tướng, đồng ý luyện hồn?
E_STR_ACCOUNT_OPTIONAL	可选	Có thể chọn
E_STR_ACCOUNT_INVALID_USERNAME	请输入正确的用户名(格式为中文、英文和数字的组合，长度3~16)	Hãy nhập chính xác tên đăng nhập (bao gồm chữ và số , độ dài 3~16)
E_STR_ACCOUNT_INVALID_EMAIL	请输入合法的邮箱格式	Hãy nhập email chính xác
E_STR_ACCOUNT_SEND_PASS_EMAIL	验证信息已发送您的密保邮箱，请注意查收	Thông tin xác nhận đã được gửi đến email của ngươi, chú ý kiểm tra email )
E_STR_ACCOUNT_ERROR_INPUT_USERNAME	请输入用户名	Hãy nhập tên đăng nhập
E_STR_ACCOUNT_SURE_TO_BONDING_GUEST_ACCOUNT	确定要绑定游客账号吗？	Đồng ý xác nhập tài khoản du khách?
E_STR_RELOGIN	服务器列表获取失败，请重新登录	Danh sách máy chủ thất bại, hãy đăng nhập lại
E_STR_ZHU_DONG_JI_NENG	主动技能	Chủ động 
E_STR_BEI_DONG_JI_NENG	被动技能	Bị động 
E_STR_RESET_SUCCEESS	重置成功	Làm mới thành công
E_STR_ACCOUNT_BONDING_SUCCESS	绑定账号成功！	Xác nhập tài khoản thành công !
E_STR_ACCOUNT_REGISTER_TITLE_REG	注册账号	Đăng ký
E_STR_ACCOUNT_REGISTER_TITLE_BOND	绑定账号	Xác nhập tài khoản
E_STR_WHEEL_AWARD_REMIND	领奖则结束当前轮,是否确定？	Nhận thưởng sẽ kết thúc hồi trước đó, đồng ý ?
E_STR_CONFIRM_AWARD	确定领奖	OK
E_STR_CONTINUE_TURN	继续转动	Tiếp tục
E_STR_LOOK_POSITION	查看阵型	Trận hình
E_STR_LOOK_BOX	查看宝箱	Bảo Rương
E_STR_KILLTWO_FINISH	今日已通关，请明日再来！	Hôm nay đã thông quan, mời ngày mai quay lại nhé !
E_STR_NEW_SIGN_VIP_DOUBLE	V%d双倍	V%d x2
E_STR_TODAY_SIGN	今日签到	Điểm danh
E_STR_VIP_GOT	补领	Nhận bổ sung
E_STR_GAIN_GOLD_DESC	获得%d金币	Nhận được %d Vàng 
E_STR_GAIN_CASH_DESC	获得%d元宝	Nhận được %d KNB
E_STR_GAIN_HONOR_DESC	获得%d军功	Nhận được %d Quân Công 
E_STR_GAIN_FOOD_DESC	获得%d粮食	Nhận được %d Lúa 
E_STR_GAIN_SOUL_DESC	获得%d将魂	Nhận được %d Tướng Hồn
E_STR_ACTIVATION	已激活	Đã kích hoạt
E_STR_INACTIVE	未激活	Chưa kích hoạt
E_STR_COUNTDAY_DESC	%s天	%s ngày
E_STR_EXTRAGET_DESC	额外获得%s	Nhận được thêm %s
E_STR_GETAWARD_DESC	领取%s	Nhận %s
E_STR_ACTIVITY_TIEM_DESC	活动时间：%d月%d日-%d月%d日	Thời gian sự kiện: ngày %d tháng %d - ngày %d tháng %d
E_STR_ACTIVITY_TIMEOUT_DESC	抱歉，活动已结束！	Tiếc quá, sự kiện đã kết thúc !
E_STR_GOTO_PAY	前往充值	Nạp ngay
E_STR_PRAY_TOTAL_AWARD	本次祈福共获得如下奖励	Cần Phúc lần này nhận được
E_STR_DIVINITY_EMBATTLING_DONE	美人出战成功	Mỹ nhân xuất chiến thành công
E_STR_DIVINITY_RECALL_DONE	美人召回成功	Mỹ nhân triệu hồi thành công
LEIGON_MY_HONOR_DESC	个人贡献	Cống Hiến
LEIGON_EXP_DESC	军团经验	Exp Quân Đoàn  
LEIGON_GAIN_MY_HONOR_DESC	获得%d个人贡献	Nhận được %d Cống Hiến
LEIGON_GAIN_EXP_DESC	获得%d军团经验	Nhận được %d Exp Quân Đoàn 
E_STR_REFRSH_COST_INTERGAL	刷新消耗积分: %d	Làm mới cần: %d điểm
E_STR_OPEN_COST_INTERGAL	抽牌消耗积分: %d	Rút bài cần: %d điểm
E_STR_TURN_CARD_NUM_ARRIVE_MAX	翻牌次数已达上限	Số lần lật bài đã đạt giới hạn
E_STR_LUCKY_CARD_ORIGINAL_JF_TEXT	每轮结束重置刷新和翻牌消耗	Kết thúc mỗi hồi tái thiết lập làm mới và lật bài tiêu hao
E_STR_LUCKY_CARD_CONTINUE_TURN	继续翻牌	Tiếp tục
E_STR_GAIN	获取	Tìm
E_DIVINITY_OPEN_TEXT	通关“%s”开启	Thông quan “%s” mở
E_STR_HAVE_EMAIL	已绑定邮箱	Đã xác nhập email
E_STR_SKILL_NO_OPEN	尚未开启	Chưa mở
E_SDK_LOGIN_FAILED	登录失败，请重新登录！	Đăng nhập thất bại, hãy đăng nhập lại !
E_STR_CONGRATULATION_GET_BEAUTY	恭喜成功解救%s！	Chúc mừng thành công giải cứu %s !
E_STR_EXPERIENCE_MAGIC	谋略	Mưu Lược 
E_STR_BUY_GOLD_LIMIT	君主等级%d级可购买金币	Quân Chủ cấp %d có thể mua Vàng 
E_ONERIDE_FINISH_NOTICE_DESC	已通过所有关卡，请重置后继续挑战！	Đã thông qua tất cả quan ải, hãy làm mới rồi tiếp tục khiêu chiến !
E_STR_ONERIDE_RESET_DESC	使用%d元宝重置后返回第一关卡！（剩余重置次数：%d次）	Sử dụng %d KNB làm mới xong quay lại quan ải 1! (số lần làm mới còn lại: %d lần)
E_STR_BOSS_SKIP_INFO	打BOSS呢，没法跳过，认真点	Đánh BOSS, không bỏ qua được đâu, tập trung đi 
E_STR_PVP_SKIP_INFO	马上就要决出胜负了，别猴急	Lập tức xác nhận được thắng bại thôi, đừng nôn nóng
E_STR_PVE_SKIP_INFO	对手马上就嗝屁了，君主大人请稍等片刻	Đối thủ sắp phải sợ lắm rồi, mời Quân Chủ đại nhân chờ trong giây lát
E_PASS_WORD_ERR	请看一下您是否修改了系统时间	Hãy xem thử có phải ngươi đã sửa đổi hệ thống thời gian ?
E_ENTER_VALID_EMAIL	请输入正确的邮箱	Hãy nhập chính xác email
E_STR_WORLD_BOSS_START_DESC	开战倒计时：	Cách khai chiến còn:
E_STR_WORLD_BOSS_WARING_DESC	结束倒计时：	Kết thúc còn:
E_STR_WORLD_BOSS_DRAGON_BALL_BUY	是否花费%s元宝购买一颗龙珠?	Đồng ý dùng %s KNB mua 1 viên Long Châu?
E_STR_HURT_REACH_VALUE	伤害达到%s万	Sát thương đạt đến %s vạn
E_STR_WORLDBOSS_WARING	Boss战进行中...	Đang tiến hành chiến BOSS
E_STR_CLEAR_REWARD_CD_DESC	奖励清空倒计时：	Xóa phần thưởng còn:
E_STR_COST_CASH_INSPIRE_MORALE	是否花费%s元宝增加%s攻击力?	Đồng ý dùng %s KNB tăng %s lực công kích ?
E_STR_COST_GOLD_INSPIRE_MORALE	是否花费%s金币增加%s攻击力?	Đồng ý dùng %s Vàng tăng %s lực công kích ?
E_STR_INSPIRE_MAX_LIMIT	鼓舞已达上限！	Cổ vũ đã đạt giới hạn
E_STR_NO_PERSON_ON_RANK	暂无排名	Chưa có xếp hạng
E_STR_FINAL_KILL_BOSS_NAME	绝杀者：%s	Kẻ giết Boss: %s
E_STR_FINAL_KILL_BOSS_GAIN	最后将BOSS击杀者可获得	Người sau cùng giết chết BOSS được nhận
E_STR_SUCCESS_INSPIRE	鼓舞成功！	Cổ vũ thành công !
E_STR_WORLD_BOSS_KILLED	世界BOSS已被击杀！	BOSS đã bị giết ! 
E_STR_WORLD_BOSS_END	世界BOSS活动已结束！	Sự kiện BOSS đã kết thúc !
E_STR_WORLD_BOSS_HURT	<font color='#009CFF'>本次对BOSS造成</font><font color='#FF0000'>%d</font><font color='#009CFF'>伤害</font>   	<font color='#009CFF'>Lần này gây</font> <font color='#FF0000'>%d</font> <font color='#009CFF'>sát thương</font> cho BOSS             
E_STR_WORLD_BOSS_AUTOEND	自动挂机已结束	Treo máy đã kết thúc
E_STR_CLICK_BOX_LOOK_INFO	点击宝箱查看奖励	Ấn vào Bảo Rương xem phần thưởng
E_STR_LAST_WORLDBOSS_RANK	上轮您的排名：%s	Hạng trước đó: %s
E_STR_WORLD_BOSS_REVIVE	是否花费%s元宝重生，重生后可立即开始挑战。	Đồng ý dùng %s KNB trùng sinh, sau khi trùng sinh có thể bắt đầu khiêu chiến ngay.
E_STR_JOIN_REWARD	参战奖励	Phần thưởng tham chiến
E_STR_KILL_REWARD	绝杀奖励	Phần thưởng tuyệt sát
E_STR_DRAGONBALL_REWARD	龙珠宝箱奖励	Long Châu Bảo Rương 
E_STR_HURT_REWARD	累计伤害奖励	Phần thưởng 
E_STR_ONERIDE_RESET_OVER	今日重置次数已用完，提升VIP等级可增加重置次数。	Đã dùng hết số lần làm mới hôm nay, tăng cấp VIP có thể tăng số lần
E_STR_MOPUP_MAX_LIMIT	（上限%d次）	(Tối đa %d lần)
E_STR_RESET_ONERIDE_FREE_DESC	本次重置免费，重置后返回第一关卡（剩余免费重置：%d次）	Lần làm mới này miễn phí, sau khi làm mới quay lại quan ải 1 (miễn phí làm mới còn lại: %d lần)
E_STR_EXCHANGE_ROLE_DESC	使用该卡可以召唤%s	Sử dụng thẻ này có thể triệu hồi %s
E_STR_ACTIVITY_END_DESC	本次活动已结束，敬请期待下次活动。	Sự kiền lần này đã kết thúc, hãy đợi sự kiện lần sau nhé
E_STR_ACTIVITY_END_AND_GET_REWARD_DESC	奖励已领取，敬请期待下次活动！	Sự kiện lần này đã kết thúc, lần sau quay lại nhé !
E_STR_EXTRA_GAIN_BALL_DESC	额外获得%d颗%d星龙珠！	Nhận được thêm %d viên %d Long Châu !
LEGION_NAME_EMPTY	军团名称不能为空！	Tên Quân Đoàn không được để trống !
LEGION_NAME_TOO_LONG	军团名称不能超过%d个字！	Tên Quân Đoàn không được vượt quá %d chữ !
LEGION_NAME_RULE	军团名称只能为汉字，字母或数字！	Tên Quân Đoàn chỉ có thể là chữ cái hoặc số !
LEGION_DESC_TOO_LONG	军团公告不能超过%d个字！	Quân Đoàn thông báo không được vượt quá %d chữ !
LEGION_DESC_RULE	军团公告含有非法字符！	Quân Đoàn thông báo có chứa ký tự đặc biệt
LEGION_CREATE_SUCCESS	创建成功！	Tạo mới thành công !
LEGION_CAN_NOT_JOIN_QUIT_RECENTLY	退出军团%d小时内无法加入军团！	Rời khỏi Quân Đoàn trong %d giờ sẽ không thể vào Quân Đoàn nữa !
LEGION_NEED_MONARCH_LEVEL	需要君主等级%d	Cần Quân chủ cấp %d
LEGION_APPLY_JOIN	申请加入	Xin phép tham gia
LEGION_CANCEL_JOIN	取消申请	Hủy xin phép
LEGION_DEPUTYCOMMANDER_MAX_COUNT	副军团长已达到最大人数%d！	Quân Đoàn phó đã đạt số người cao nhất là %d !
LEGION_CONFIRM_PROMOTION_DEPUTYCOMMANDER	您确认要提升%s为副军团长吗？	Bạn chắc chắn muốn tăng cấp %s thành Quân Đoàn phó?
LEGION_CONFIRM_DEMOTION_DEPUTYCOMMANDER	您确认要罢免%s的副军团长职位吗？	Bạn chắc chắn muốn bãi nhiệm Quân Đoàn phó %s?
LEGION_PROMOTION_DEPUTYCOMMANDER	您任命了%s为副军团长。	Bạn đã duyệt %s thành Quân Đoàn phó 
LEGION_DEMOTION_DEPUTYCOMMANDER	您罢免了%s的副军团长职位。	Bạn đã bãi nhiệm Quân Đoàn phó %s
LEGION_CONFIRM_PROMOTION_COMMANDER	您确定要將军团长的职位托付给%s吗？	Bạn chắc chắn ủy nhiệm chức vị Quân Đoàn trưởng lại cho %s chứ ?
LEGION_CONFIRM_MEMBER_WILL_KICKED	扣除%d点军团经验并将%s移出军团，是否确定？	Khấu trừ %d điểm Exp Quân Đoàn và đá %s khỏi Quân Đoàn, đồng ý ?
LEGION_MEMBER_KICKED	%s被移出军团	%s bị đá khỏi Quân Đoàn 
LEGION_PROMOTION	提升职务	Bổ nhiệm
LEGION_DEMOTION	罢免职务	Bãi miễn
E_STR_LEGION_DONATE_GOLD	每次可捐献%s金币，今日剩余捐献次数：	Hôm nay có thể quyên góp %s Vàng, số lần quyên góp hôm nay còn:
E_STR_LEGION_DONATE_DESC	军团捐献	Quân Đoàn quyên góp 
E_STR_DONATE	捐献	Quyên góp
E_STR_LEGION_EXCHANGE_DESC	军团兑换	Tiệm Quân Đoàn
E_STR_LEGION_EXIT_DESC	军团长禅让职位后方可退出	Sau khi Quân Đoàn trưởng nhường vị có thể thoát
E_STR_LEGION_DISMISS_DESC	退出后将解散军团，确认退出?	Sau khi thoát sẽ giải tán Quân Đoàn, thoát ?
E_STR_LEGION_EXIT_TIME_PROMPT	退出军团24小时内不能再次加入军团，确认退出？	Thoát Quân Đoàn trong 24 giờ không thể vào lại Quân Đoàn, thoát ?
E_STR_LEGION_SETTING_SUCCESS_DESC	设置成功	Cài đặt thành công
E_STR_LEGION_ACTIVITY_OPEN	军团 %d 级开启	Quân Đoàn cấp %d mở 
E_STR_LEGION_ACTIVITY_TIMES	今日剩余次数：%d/%d	Hôm nay còn: %d/%d
E_STR_LEGION_ORDER_EXCHANGE_DESC	军团令购买	Mua Quân Đoàn Lệnh 
E_STR_LEGION_PEOPLE_FULL_DESC	军团人数已达上限！	Quân Đoàn Lệnh đã đạt giới hạn !
E_STR_TECH_UPGRADE_ERROR_LEVEL_LIMIT	军团科技不能超过军团等级！请提升军团等级	Khoa Kỹ không thể vượt quá cấp Quân Đoàn! Hãy tăng cấp Quân Đoàn 
E_STR_TECH_UPGRADE_SUCC	军团科技升级成功！	Tăng cấp Khoa Kỹ thành công !
E_STR_TECH_UPGRADE_ERROR_NEED_ORDER	科技令不足	Khoa Kỹ Lệnh không đủ 
LEGION_APPLY_JOIN_FULL	申请列表已满！	Danh sách xin phép đã đầy !
LEGION_CONFIRM_CREATE	是否花费%d元宝创建军团？	Đồng ý dùng %d KNB tạo mới Quân Đoàn?
LEGION_PASS_APPLICATION	通过申请	Duyệt vào Quân Đoàn
LEGION_CHANGE_COMMANDER_SUCCESS	%s从您手中接过了军团长职位。	%s từ trong tay ngươi đã nhậm chức Quân Đoàn trưởng
LEGION_SERVER_DATA_CHANGED	抱歉，后台数据已发生变更，请点击军团重新进入	Xin lỗi, dữ liệu đã cập nhật và làm mới, hãy ấn để vào lại Quân Đoàn 
LEGION_NO_AUTHORITY	抱歉，只有军团长才有此权限！	Xin lỗi, chỉ có Quân Đoàn trưởng mới có quyền hạn này !
LEGION_PRAY_NO_HONOR	军团贡献不足	Cống hiến không đủ 
LEGION_PRAY_NO_TIMES	祈福次数不足	Số lần Cầu Phúc đã hết
LEGION_NAME_REPETITION	军团名称已存在！	Tên Quân Đoàn đã tồn tại !
LEGION_DONATE_SUCCESS_DESC	捐献成功！	Quyên góp thành công !
LEGION_SEARCH_TURN_OVER_PAGE	超过最大页数！	Vượt quá số trang lớn nhất !
LEGION_MOVE_NOT_ENOUGH	行动力不足！	Hoạt lực không đủ
LEGION_ENERGY_NOT_ENOUGH	体力不足！	Thể lực không đủ
LEGION_DONATE_MATERIAL_DESC	捐献金币、科技令可获得军团贡献	Quyên góp Vàng, Khoa Kỹ lệnh nhận được Quân Đoàn cống hiến 
LEGION_OPEN_LEVEL_NOT_REACHED	君主等级%d 级开启	Quân Chủ cấp %d mở 
MONDAY_DESC	周一	Thứ 2
TUSEDAY_DESC	周二	Thứ 3
WEDNESDAY_DESC	周三	Thứ 4
THURSDAY_DESC	周四	Thứ 5
FRIDAY_DESC	周五	Thứ 6
SATURDAY_DESC	周六	Thứ 7
SUNDAY_DESC	周日	Chủ nhật
LEGION_COMING_SOON_DESC	虚位以待	Vô chủ 
LEGION_REGISTER_DESC	本军团已报名！	Quân Đoàn này đã báo danh !
LEGION_NO_REGISTER_DESC	本军团未报名！	Quân Đoàn này chưa báo danh !
LEGION_NO_PEOPLE_OCCUPY_DESC	无人占领	Vô chủ 
LEGION_DAY_DESC	%s天	%s ngày
LEGION_REGISTER_NUM_NO_ENOUGH	报名军团不足%d个！	Quân Đoàn báo danh không đủ %d !
LEGION_WAR_RUNING_TIME	每周皇城争霸时间	Thời gian Hoàng Thành Tranh Bá hàng tuần 
LEGION_BEFORE_OF_WAR_DESC	距离皇城争霸开始：	Hoàng Thành tranh bá bắt đầu sau:
LEGION_BEFORE_ONE_TURN_DESC	距离第一轮开始：	Hồi 1
LEGION_BEFORE_TWO_TURN_DESC	距离第二轮开始：	Hồi 2
LEGION_BEFORE_THREE_TURN_DESC	距离第三轮开始：	Hồi 3
LEGION_COUNT_DOWN_DESC	倒计时：	Còn:
LEGION_ONE_TURN_DESC	皇城争霸第一轮	Hoàng Thành Tranh Bá hồi 1
LEGION_TWO_TURN_DESC	皇城争霸第二轮	Hoàng Thành Tranh Bá hồi 2
LEGION_THREE_TURN_DESC	皇城争霸第三轮	Hoàng Thành Tranh Bá hồi 3
LEGION_WAR_OVER_DESC	本周争霸赛结束！	Cuộc thi tranh bá tuần này kết thúc !
LEGION_WEED_OUT_DESC	您所在的军团已被淘汰！	Quân Đoàn của ngươi đã bị loại ! 
LEGION_ONE_TURN_RUNING_DESC	争霸赛第一轮进行中	Đang tiến hành tranh bá hồi 1
LEGION_TWO_TURN_RUNING_DESC	争霸赛第二轮进行中	Đang tiến hành tranh bá hồi 2
LEGION_THREE_TURN_RUNING_DESC	争霸赛第三轮进行中	Đang tiến hành tranh bá hồi 3
LEGION_GET_REWARD_ONE_TURN_DESC	皇城争霸第一轮奖励	Hoàng Thành Tranh Bá hồi 1
LEGION_GET_REWARD_TWO_TURN_DESC	皇城争霸第二轮奖励	Hoàng Thành Tranh Bá hồi 2
LEGION_GET_REWARD_THREE_TURN_DESC	皇城争霸第三轮奖励	Hoàng Thành Tranh Bá hồi 3
LEGION_CONFIRM_BUY_MOVE	是否花费%d元宝购买%d点行动力？	Đồng ý dùng %d KNB mua %d điểm hoạt lực ?
LEGION_REGISTER_NOTICE_DESC	只有军团长和副军团长才有资格报名!	Chỉ có Quân Đoàn trưởng và Quân Đoàn phó mới có tư cách báo danh !
LEGION_BATTLE_PROMOTION_SUCCESS	恭喜！您所在的军团成功晋级下一轮	Chúc mừng ! Quân Đoàn của ngươi đã thành công tiến vào vòng trong 
LEGION_BATTLE_PROMOTION_FAILED	很遗憾，您所在的军团未能晋级	Thật đáng tiếc, Quân Đoàn của ngươi chưa thể tiến vào vòng trong 
LEGION_MYMAINCITY	主城 · %s	Chủ thành %s
LEGION_MYVICECITY	附城 · %s	Phụ thành %s
LEGION_ATTACK_BUFF	(军团全员攻击+%d%%)	(Toàn thể Quân Đoàn công kích +%d%%)
LEGION_PROMOTE_EMPEROR	恭喜贵军团成为皇城霸主！	Chúc mừng Quân Đoàn này đã trở thành Hoàng Thành bá chủ !
LEGION_WAR_NO_OPEN_DESC	本周争霸赛无法开赛	Cuộc thi tranh bá tuần này không thể bắt đầu
LEGION_ALL_ASSIGN_ROLE_DESC	全体武将	Tất cả Võ Tướng 
LEGION_ALL_ROLE_ATTACK_BUFF	攻击+%d%%	Công kích +%d%%
LEGION_ALL_ROLE_HEALTH_BUFF	士兵+%d%%	Binh Lực +%d%%
LEGION_ALL_ROLE_DEFENCE_BUFF	防御+%d%%	Phòng ngự +%d%%
LEGION_ALL_ROLE_MDEFENCE_BUFF	谋防+%d%%	Mưu Phòng +%d%%
LEGION_SERVER_DATA_CHANGED_REFRESH	抱歉，数据已变更并刷新	Xin lỗi, dữ liệu đã cập nhật và làm mới
LEGION_WAR_BATTLEFIELD_INIT_DESC	战场初始化中	Chiến trường đang khởi động
LEGION_FINAL_WAR_DESC	最终战	Kết quả
LEGION_LAST_FINAL_WAR_RESULT_DESC	上届皇城争霸最终结果	Hoàng Thành Tranh Bá kỳ trước
LEGION_FINAL_WAR_RESULT_DESC	本届皇城争霸最终结果	Hoàng Thành Tranh Bá kỳ này
LEGION_CAN_NOT_OPERATE_DURING_WAR	军团战期间不能进行此项操作	Thời gian Quân Đoàn chiến không thể tiến hành thao tác này 
LEGION_WAR_BALANCE	战场结算中...	Đang tổng kết chiến trường…
LEGION_OUT_REGISTER_TIME	报名时间已过期！	Thời gian báo danh đã quá hạn !
LEGION_IMMEDIATELY_JOIN	立即加入	Xin gia nhập
LEGION_CITY_NO_LEGION	【无】	[Không]
LEGION_BATTLE_INFO_REFRESH	战场情报已刷新！	Chiến trường tình báo đã làm mới !
LEGION_FINISH_KILL_DESC	%s完成了%d连斩!	%s đã hoàn thành %d liên trảm !
LEGION_DEFENCE_FAILED_MESSAGE	你被%s击败，损失了%d点体力。	Bạn bị %s đánh bại, tổn thất %d điểm thể lực. 
LEGION_DEFENCE_FAILED_AND_GOHOME_MESSAGE	你被%s击败，损失了%d点体力，体力耗尽回到主城休养生息。	Bạn bị %s đánh bại, tổn thất %d điểm thể lực, thể lực cạn kiệt quay về chủ thành nghỉ ngơi lấy lại sức thôi.
LEGION_DEFENCE_SUCCEED_MESSAGE	你成功抵御了%s的进攻，消耗了%d点体力。	Bạn đã thành công chống cự được sự tấn công của %s, tiêu hao %d điểm thể lực.
LEGION_DEFENCE_SUCCEED_AND_GOHOME_MESSAGE	你成功抵御了%s的进攻，消耗了%d点体力，体力耗尽回到主城休养生息。	Bạn đã thành công chống cự được sự tấn công của %s, tiêu hao %d điểm thể lực, thể lực cạn kiệt quay về chủ thành nghỉ ngơi lấy lại sức thôi.
LEGION_USEUP_GOLD_DONATE_TIMES	今日金币捐献次数已用完！	Hết lượt quyên góp !
LEGOIN_BOSS_BUFF_LAST	攻击+%d%%，剩余持续%d场战斗	Công kích +%d%%, duy trì %d trận
LEGION_KILL_BOSS_BUFF	击杀BUFF	Kích sát BUFF
LEGION_KILL_BOSS_BUFF_NUMBER	攻击+%d%%	Công kích +%d%%
LEGION_DO_NOT_BEAT_OTHERS	别打了，对方已经嗝屁了	Đừng đánh nữa, đối phương đã sợ lắm rồi
LEGION_BUY_TIMES_OVER	今日购买次数已用完	Đã dùng hết số lần mua hôm nay
LEGION_REMAIN_TIMES	剩余%d次	Còn lại %d lần
LEGION_FREE_REVIVE	免费复活	Hồi phục
LEGION_CASH_REVIVE	元宝复活	Hồi phục KNB
LEGION_CASH_REVIVE_CONFIRM	本次复活將花费%d元宝，是否确定复活(剩余元宝复活次数：%d次)	Lần hồi phục này dùng %d KNB, đồng ý hồi phục (Số lần KNB hồi phục còn lại: %d lần)
E_STR_RANK_HIGHEST_RANK_PANEL	历史最高排名：%d	Hạng cao nhất: %d
E_STR_PAWNSHOP_NOT_ENOUGH_CASH	您当前元宝不足，是否前往充值？	Hiện tại KNB của ngươi không đủ, đổi KNB ?
E_STR_ACCPAY_RECHARGE	充值满%d元宝即可获得	Nạp đủ %d KNB sẽ nhận được ngay
E_STR_ACCPAY_GOT_REWARD_1	已领	Đã nhận
E_STR_ACCPAY_REWARD_OUT_OF_TIME	活动已结束，请尽快领取奖励	Sự kiện đã kết thúc, hãy nhanh chóng nhận phần thưởng
BALL_BUY_TIMES_OVER	龙珠购买次数已达上限！	Số lần mua Long Châu đã đạt giới hạn
REVIVE_BUY_TIMES_OVER	今日复活次数已用完！	Đã dùng hết số lần hồi phục hôm nay !
GOLD_INSPIRE_TIMES_OVER	今日金币鼓舞次数已用完！	Đã dùng hết số lần Kim cổ vũ hôm nay !
CASH_INSPIRE_TIMES_OVER	今日元宝鼓舞次数已用完！	Đã dùng hết số lần KNB cổ vũ hôm nay !
E_STR_MOPUP_MAX_LIMIT_DESC	君主%d级或VIP%d级扫荡次数上限提升至%d次	Quân Chủ cấp %d hoặc VIP %d số lần càn quét tối đa tăng đến %d lần
E_STR_UPGRADE_NEED_MOPUP_TIMES	升级还需扫荡：%d次	Tăng cấp cần: %d lần 
LEGION_MAX_APPLY_PEOPLE	该军团申请人数达到上限	Số lượng người xin Quân Đoàn này đã đạt giới hạn
LEGION_NAME_REPEAT	当前已有军团采用此名称，请重新确定军团名称	Hiện tại đã có Quân Đoàn sử dụng tên này, mời hãy nhập lại tên khác
E_STR_GIFTS_TARGET_DESC_1	等级达到%d级	Đạt cấp %d
E_STR_GIFTS_TARGET_DESC_2	拥有%d个彩将	Có %d Thần Tướng 
E_STR_GIFTS_TARGET_DESC_3	%d个武将完成1转	%d Võ Tướng tiến cấp 1 lần
E_STR_GIFTS_TARGET_DESC_4	%d个武将技达到%d级	%d Võ Tướng kỹ năng đạt cấp %d
E_STR_GIFTS_TARGET_DESC_5	镶嵌%d颗%d级宝石	Khảm %d viên Ngọc cấp %d
E_STR_GIFTS_TARGET_DESC_6	战斗力达到%d	Lực chiến đạt đến %d
E_STR_GIFTS_DAY_DESC_1	进入游戏第一天，君主等级达到对应等级即可领取奖励	Ngày 1, cấp Quân Chủ đạt đến cấp tương ứng sẽ nhận ngay phần thưởng 
E_STR_GIFTS_DAY_DESC_2	进入游戏第二天，拥有彩将达到对应数目即可领取奖励	Ngày 2, sở hữu Thần Tướng đạt đến con số tương ứng sẽ nhận ngay phần thưởng 
E_STR_GIFTS_DAY_DESC_3	进入游戏第三天，武将转职达到对应条件即可领取奖励	Ngày 3, số Võ Tướng tiến cấp 1 lần đạt đến con số tương ứng sẽ nhận ngay phần thưởng
E_STR_GIFTS_DAY_DESC_4	进入游戏第四天，武将技能达到对应条件即可领取奖励	Ngày 4, số Võ Tướng có kỹ năng đạt đến con số tương ứng sẽ nhận ngay phần thưởng 
E_STR_GIFTS_DAY_DESC_5	进入游戏第五天，镶嵌宝石达到对应数目即可领取奖励	Ngày 5, số Ngọc khảm vào trang bị đạt đến con số tương ứng sẽ nhận ngay phần thưởng 
E_STR_GIFTS_DAY_DESC_6	进入游戏第六天，君主战力达到对应战力即可领取奖励	Ngày 6, Lực Chiến đạt đến con số tương ứng sẽ nhận ngay phần thưởng 
E_STR_GIFTS_DAY_BTN_DESC_1	冲级获奖	Tăng cấp 
E_STR_GIFTS_DAY_BTN_DESC_2	招将返利	Chiêu tướng
E_STR_GIFTS_DAY_BTN_DESC_3	转职送礼	Tiến cấp
E_STR_GIFTS_DAY_BTN_DESC_4	竞技升级	Nâng cấp kỹ năng
E_STR_GIFTS_DAY_BTN_DESC_5	镶嵌送礼	Khảm ngọc
E_STR_GIFTS_DAY_BTN_DESC_6	战力提升	Nâng cao lực chiến
E_STR_GIFTS_DAY_BTN_DESC_7	未达标	Chưa đạt
E_STR_GIFTS_REMINDER_DESC	您有之前达成目标后的奖励未领取，请注意领取。	Bạn có phần thưởng đạt mục tiêu trước đó vẫn chưa nhận, chú ý nhận nhé.
E_STR_ONLY_SRED_ROLE_AWAKE	只有彩色武将可觉醒	Chỉ có Thần Tướng có thể Phong Thần
E_STR_NO_OPEN_THIS_ROLE_AWAKE	本武将觉醒尚未开放	Võ Tướng này vẫn chưa mở Phong Thần
E_STR_SOLDIER_LEVEL_AND_SOLDIER_LEVEL	%d阶/%d阶	Cấp %d/%d
E_STR_NO_ROLE_AWAKE_SOLDIER_LEVEL	兵种转职到3阶方可进行觉醒	Binh chủng tiến cấp đến cấp 3 có thể Phong Thần
E_STR_NO_ROLE_AWAKE_GOD_FRAGMENT	神将碎片不足，参加世界boss可获得神将碎片	Mảnh Phong Thần không đủ, tham gia BOSS có thể nhận được Mảnh Phong Thần
E_STR_PVE_SKIP_INFO1	VIP%d级可跳过战斗	VIP %d có thể bỏ qua chiến đấu 
AND_CLOSE	你确定要退出游戏吗？	Bạn chắc chắn muốn thoát khỏi trò chơi ?
E_STR_GOT_CDKEY	同一活动激活码只能使用一次	Cùng một Giftcode chỉ được sử dụng 1 lần
E_STR_TOMB_FIGHT	挑战	Khiêu chiến
E_STR_MAX_CHALENGE_TIME	今日次数已用完，请明日再来	Đã dùng hết số lần hôm nay, ngày mai quay lại nhé !
CHANGE_ACCOUNT	重启游戏，切换账号？	Khởi động lại trò chơi, đổi tài khoản
E_STR_SKILL_BOOK	恭喜合成%d本技能书	Chúc mừng ghép %d sách kỹ năng 
E_STR_URL	http://www.yaowan.com/?m=topic&action=mdcactivity	Ấn nhận thưởng, đồng ý nhận <font color=
LOGIN_LOSE_EFFICACY	登录失效,请重新启动游戏。	Đăng nhập thất bại, hãy khởi động lại trò chơi
E_STR_WELFARE_DESC	你目前不是VIP，无法领取第四项VIP专属奖励，确定只领取前三项奖励吗？	Hiện tại ngươi không phải VIP, không thể nhận phần thưởng thứ 4 quyền lợi VIP, đồng ý nhận 3 phần thưởng trước đó chứ ?
E_STR_WELFARE_END	已结束	Đã kết thúc
E_STR_WELFARE_NORANK	未上榜	Chưa có
E_STR_WELFARE_NORANK1	无人上榜	Không có
E_STR_GETAWARD_COUNTDOWN	领奖倒计时:	Nhận thưởng còn:
E_STR_WELFARE_TIMEEND	结束倒计时:	Kết thúc còn:
E_STR_WELFARE_RECHARG_DESC	个人累计消费:	Tích lũy tiêu phí cá nhân:
E_STR_WELFARE_RANK_DESC	当前排行:	Hạng hiện tại:
E_STR_WELFARE_NAME_DESC	单服累计消费元宝：	Đơn phục tích lũy KNB:
HELP_TRAINING_1	进入训练馆，点击卡牌上的<img src='uires/ui_2nd/com/common_btn/upgrade_1.png'/>按钮即可为训练位升级。	Vào Thao Trường, ấn vào nút <img src='uires/ui_2nd/com/common_btn/upgrade_1.png'/> để tăng cấp huấn luyện
HELP_TRAINING_2	点击标有“点击训练”的训练位，选择武将可进行训练。	Ấn vào ô huấn luyện có hiển thị “Ấn để huấn luyện”, chọn Võ Tướng có thể tiến hành huấn luyện 
HELP_TRAINING_3	同一武将可重复进行训练，武将训练后可立刻得到对应武将经验。	Cùng một Võ Tướng có thể lặp lại huấn luyện, sau khi huấn luyện sẽ nhận ngay Exp Võ Tướng tương ứng 
HELP_TRAINING_4	点击加速可通过消耗元宝来清除该训练位的冷却时间。	Ấn tăng tốc có thể dùng KNB để xóa thời gian chờ huấn luyện
HELP_TRAINING_5	训练位分别有“青铜训练位”、“白银训练位”、“黄金训练位”三个品级。	Huấn luyện phân biệt có 3 cấp bậc “Thanh Đồng huấn luyện”, “Bạch Ngân huấn luyện”, “Hoàng Kim huấn luyện”
HELP_TRAINING_6	训练位需要VIP等级以及消耗元宝来进行升级。	Huấn luyện yêu cầu cấp VIP và tiêu hao KNB để tiến hành tăng cấp 
HELP_TRAINING_7	VIP3以上可升级为白银训练位	VIP3 trở lên có thể tăng cấp thành Bạch Ngân huấn luyện
HELP_TRAINING_8	VIP6以上可升级为黄金训练位	VIP6 trở lên có thể tăng cấp thành Hoàng Kim huấn luyện
HELP_MILITARY_1	点击“刷新”按钮后，当前兵种陈列的属性重置。	Sau khi ấn nút “Làm mới”, thiết lập lại các thuộc tính binh chủng hiển thị hiện tại 
HELP_MILITARY_2	选择一个陈列的属性后，点击“历练”有几率提升该项属性，每次历练将消耗一些军功。(军功可在擂台获得)	Sau khi chọn một thuộc tính hiển thị, ấn “tập luyện” có tỉ lệ nâng cao thuộc tính này, mỗi lần tập luyện mất 1 ít Quân Công. (Quân Công có thể nhận được tại Lôi Đài)
HELP_MILITARY_3	点击兵种上的放大镜按钮，可查看该兵种所有历练属性的值。	Ấn vào nút phóng đại trên binh chủng, có thể xem được tất cả chỉ số tập luyện thuộc tính của binh chủng này
HELP_MILITARY_4	历练属性按档次分为白、<font color='#009CFF'>蓝</font>、<font color='#D800FF'>紫</font>、<font color='#FE9B00'>橙</font>四个品级。品级越好，历练成功后提升的属性越高，消耗军功数量也越多。	Thuộc tính tập luyện căn cứ theo trắng, <font color='#009CFF'>lam</font>, <font color='#D800FF'>tím</font>, <font color='#FE9B00'>cam</font> 4 loại cấp bậc. Cấp bậc càng tốt, thì sau khi tập luyện thành công thuộc tính sẽ càng cao, tiêu hao số lượng Quân Công càng nhiều
HELP_MILITARY_5	成功率的上限为100%，历练成功会降低5%的成功率。	Tỉ lệ thành công giới hạn là 100%, tập luyện thành công sẽ giảm 5% của tỉ lệ thành công
HELP_TAVERN_1	招贤馆可招募到的武将品质由低到高分为<font color='#009CFF'>蓝</font>、<font color='#D800FF'>紫</font>、<font color='#FE9B00'>橙</font>、<font color='#FF0000'>血</font>色武将	Tửu Quán có thể chiêu mộ Võ Tướng có phẩm chất <font color='#009CFF'>Lam</font>, <font color='#D800FF'>Tử</font>, <font color='#FE9B00'>Kim</font>, <font color='#FF0000'>Huyết</font>, Thần
HELP_TAVERN_2	积攒一定数量的将魂可以在兑换界面兑换自己喜欢的极品武将	Thu thập đủ số lượng Tướng Hồn có thể đổi Võ Tướng cực phẩm mà mình yêu thích tại màn hình đổi
HELP_TAVERN_3	每日内，随着每次金币招募所需金币数量的增加，招募到<font color='#FF0000'>血</font>色武将的概率也会增加!	Hằng ngày, tùy vào sự tăng lên của số Vàng cần thiết mỗi lần, tỉ lệ thành công chiêu mộ được <font color='#FF0000'>Huyết Tướng</font> cũng sẽ tăng lên 
HELP_TAVERN_4	招募武将达到数量限制或出现重复武将时，则转为卡牌存放在“背包”中，“背包”中的武将卡可“召唤”激活，也可“分解”为将魂。	Khi chiêu mộ Võ Tướng đạt số lượng giới hạn hoặc xuất hiện trùng lắp, sẽ chuyển thành thẻ và được để trong Túi, thẻ Võ Tướng trong “túi” có thể “triệu hồi”, cũng có thể “phân giải” thành Tướng Hồn
HELP_SIGN_1	每日签到可获得相应奖励。	Điểm danh hằng ngày nhận được phần thưởng tương ứng
HELP_SIGN_2	在特定天数中，达到对应VIP等级及以上的玩家可领取翻倍奖励。	Trong trường hợp đặc biệt, người chơi đạt cấp VIP tương ứng trở lên sẽ nhận được phần thưởng gấp đôi.
HELP_SIGN_3	VIP奖励可以当日内升级VIP后进行补领。	Phần thưởng VIP có thể nhận bổ sung sau khi tăng cấp VIP trong ngày
HELP_SIGN_4	每日签到在0点进行刷新。当月未领取的奖励可点击补签按钮领取。	Điểm danh hằng ngày được làm mới lúc 0 giờ. Tháng đó nếu chưa nhận phần thưởng thì có thể ấn vào nút điểm danh bổ sung để nhận
HELP_SIGN_5	补签领取的奖励对应玩家当前VIP等级，并需要消耗少量元宝。	Nhận phần thưởng điểm danh bổ sung tương ứng với cấp VIP hiện tại của người chơi, và phải tiêu hao ít KNB. 
HELP_TOMB_1	君主可以向守墓士兵发起挑战，胜利后可以获得宝石，有一定几率获得<font color='#FE9B00'>5、6、7级宝石</font>	Quân Chủ có thể chủ động khiêu chiến Thủ Mộ Sĩ Binh, sau khi chiến thắng nhận được Ngọc, có tỉ lệ nhất định nhận được <font color='#FE9B00'>Ngọc cấp 5</font>
HELP_TOMB_2	每次挑战后，高级宝石的掉落概率都会增加，直至掉落高级宝石为止	Sau mỗi lần khiêu chiến, xác suất nhận Ngọc cao cấp đều tăng lên
HELP_TOMB_3	每次挑战成功后，扣除对应元宝，挑战失败不扣除元宝	Sau mỗi lần khiêu chiến thành công, tiêu knb tăng 5knb, thất bại ko mất KNB
HELP_TOMB_4	每日挑战次数为12次，每挑战成功一次扣除一次次数，失败不扣除次数	Số lần khiêu chiến mỗi ngày là 12, khiêu chiến thành công trừ 1, khiêu chiến thất bại không bị trừ
HELP_TRENA_1	点击界面中的玩家形象可以进行挑战。	Ấn vào hình tượng người chơi có thể tiến hành khiêu chiến 
HELP_TRENA_2	向上滑动擂台界面可查看排名前五的玩家。	Trượt lên giao diện Lôi Đài có thể xem người chơi 5 hạng đầu 
HELP_TRENA_3	擂台等级越高，每小时获得的军功越高。	Cấp Lôi Đài càng cao, Quân Công nhận được mỗi giờ càng cao 
HELP_TRENA_4	主动挑战获胜时，可获得擂台经验。	Khi chủ động khiêu chiến chiến thắng, nhận được Exp Lôi Đài 
HELP_TRENA_5	挑战失败不会扣除擂台经验。	Khiêu chiến thất bại sẽ không bị trừ Exp Lôi Đài
HELP_TRENA_6	挑战擂台等级比自身低10级的玩家不获得擂台经验。	Khiêu chiến người chơi có cấp Lôi Đài nhỏ hơn bản thân 10 cấp sẽ không nhận được Exp Lôi Đài.
HELP_TRENA_7	每天20:00后可领取擂台排名奖励(奖励无法累计)。	Hằng ngày sau 20:00 sẽ nhận được phần thưởng xếp hạng Lôi Đài (không cộng dồn)
HELP_TRENA_8	每天20:00后重置免费挑战次数。	Sau 20:00 giờ hằng ngày thiết lập lại số lần khiêu chiến miễn phí
HELP_GOLDMINE_1	金矿战斗分为“掠夺”（已被占领的金矿），“占领”（未被占领的金矿）	Ngân Khoáng chiến đấu chia thành “cướp” (Ngân Khoáng đã bị chiếm), “chiếm” (Ngân Khoáng chưa bị chiếm)
HELP_GOLDMINE_2	每天免费占领或掠夺金矿%d次，当天的次数使用完后，可消耗元宝购买占领或掠夺金矿的次数。	Hằng ngày miễn phí chiếm hoặc cướp Ngân Khoáng %d lần, khi sử dụng hết, có thể dùng KNB mua thêm số lần
HELP_GOLDMINE_3	占领期间被其他玩家击败，失去金矿，并被掠夺部分金币。产量越多的矿可掠夺的金币比例越大，失败则赔偿越多。如下图所示：	Trong lúc chiếm bị người chơi khác đánh bại, cướp mất Ngân Khoáng, và bị cướp một số Vàng, số Vàng đền bù dư sẽ bị hệ thống thu hồi 
HELP_GOLDMINE_4	通过赔偿获得的金币不能超过金矿正常产出的两倍，多余的赔偿金币将被系统回收	Số Vàng bồi thường nhận được không được vượt quá 2 lần số mà Ngân Khoáng sản sinh, số Vàng bồi thường dư ra sẽ bị hệ thống thu hồi 
HELP_LUCKYCARD_1	活动期间，每充值1元宝对应获得1积分。	Trong thời gian sự kiện, cứ nạp 1 KNB sẽ nhận tương ứng 1 Điểm
HELP_LUCKYCARD_2	幸运翻牌活动中，翻牌和刷新都只能消耗积分。	Trong thời gian sự kiện, lật bài hay làm mới đều tiêu hao Điểm
HELP_LUCKYCARD_3	每一轮翻牌开始前，点击刷新按钮可刷新奖励，刷新消耗的积分会随着翻牌次数增长。	Trước khi lật bài, ấn vào nút làm mới có thể làm mới phần thưởng
HELP_LUCKYCARD_4	每一轮翻牌中，翻牌消耗的积分会随着翻牌次数增长而增长。	Trong mỗi lần lật bài, Điểm tiêu hao tùy thuộc số lần lật bài 
HELP_LUCKYCARD_5	每一轮开始时，重置翻牌次数和刷新次数。	Mỗi lần bắt đầu, thiết lập lại số lần lật bài và làm mới số lần 
HELP_LUCKYCARD_6	领取奖励后，本轮结束。	Sau khi nhận phần thưởng, lần lật bài đó kết thúc 
HELP_BOSS_AWARD_1	世界BOSS活动每晚19:30开始，持续30分钟，等级27级以上的玩家才能参与活动	Sự kiện BOSS bắt đầu lúc 19:30 mỗi tối, duy trì 30 phút, người chơi cấp 27 trở lên mới được tham gia sự kiện 
HELP_BOSS_AWARD_2	活动过程中BOSS被击杀后活动提前结束	Trong thời gian sự kiện, sau khi BOSS bị kích sát thì sự kiện sẽ kết thúc sớm hơn
HELP_BOSS_AWARD_3	活动后按照对BOSS的伤害排名发放奖励	Sau sự kiện sẽ căn cứ vào xếp hạng sát thương của BOSS để phát phần thưởng 
HELP_BOSS_AWARD_4	对BOSS造成最后一击的君主将获得特殊奖励	Quân Chủ ra đòn cuối cùng khi đánh BOSS sẽ được nhận phần thưởng đặc biệt 
HELP_BOSS_AWARD_5	对BOSS的伤害累积到一定程度，可以获得累伤奖励	Tích lũy sát thương khi đánh BOSS đạt trình độ nhất định, sẽ nhận được phần thưởng sát thương
HELP_BOSS_AWARD_6	累伤奖励产出龙珠，龙珠也可以通过消耗元宝购买获得	Chỉ số sát thương tích luỹ khác nhau sẽ nhận đc phần thưởng Ngọc Rồng loại khác nhau
HELP_BOSS_AWARD_7	凑齐7种不同龙珠可以兑换宝箱，开启后获得丰厚奖励	Thu thập đủ 7 loại Long Châu khác nhau có thể đổi Bảo Rương, sau khi mở sẽ nhận được phần thưởng hậu hĩnh
HELP_BOSS_CHALLENGE_1	活动最多持续30分钟，期间BOSS被击杀后活动提前结束	Kéo dài 30 phút, BOSS bị kích sát thì sự kiện sẽ kết thúc sớm hơn 
HELP_BOSS_CHALLENGE_2	君主们可以向BOSS发起进攻，直到BOSS被击杀为止	Quân Chủ có thể tấn công Boss, cho đến khi Boss bị kích sát mới thôi 
HELP_BOSS_CHALLENGE_3	君主们可以花费金币或元宝进行鼓舞，增加上阵武将攻击力	Quân Chủ có thể dùng Vàng hoặc KNB để tiến hành cổ vũ, tăng lực công kích của Võ Tướng xuất trận 
HELP_BOSS_CHALLENGE_4	鼓舞增加的攻击力上限为100%	Cổ vũ tăng công kích tối đa 100%
HELP_BOSS_CHALLENGE_5	每次战斗结束后，需要等待1分钟的复活时间才能再次战斗	Mỗi lần sau khi kết thúc chiến đấu, cần phải đợi 1 phút thời gian mới có thể chiến đấu lần nữa
HELP_BOSS_CHALLENGE_6	花费元宝可以清除战斗CD，立即再次投入战斗	Dùng KNB có thể xóa bỏ thời gian chờ, lập tức có thể chiến đấu lần nữa 
HELP_BOSS_CHALLENGE_7	战斗结束后根据伤害排名向君主们发放奖励	Sau khi kết thúc chiến đấu căn cứ vào xếp hạng sát thương để phát phần thưởng cho Quân Chủ 
HELP_BOSS_CHALLENGE_8	君主们使用自动战斗可以自动与BOSS发生战斗，自动战斗无任何损耗	Quân Chủ có thể sử dụng tự động chiến đấu để chiến đấu với BOSS, tự động chiến đấu không hề tổn thất gì cả
HELP_BOSS_CHALLENGE_9	自动战斗时，不会显示战斗过程，只提示战斗结果	Khi tự động chiến đấu, sẽ không hiển thị quá trình chiến đấu, chỉ hiện thị kết quả chiến đấu
HELP_BOSS_CHALLENGE_10	使用刷新按钮可主动刷新查看BOSS血量，方便抢夺最后一击	Sử dụng nút làm mới có thể chủ động tra xem lượng máu của BOSS, thuận tiện việc cướp chiêu cuối cùng
HELP_LEGION_WAR_1	皇城争霸每周举行一次，共进行三轮比赛，周一12：00至周五12：00可报名。	Mỗi tuần tổ chức 1 lần gồm 3 hồi, báo danh từ 12:00 thứ 2 đến 12:00 thứ 6
HELP_LEGION_WAR_2	周五12：00报名截止，若不足2个军团报名，将无法启动本周皇城争霸。	Sau 12:00 thứ 6 hết hạn báo danh, nếu ít hơn 2 Quân Đoàn báo danh thì không mở hoạt động
HELP_LEGION_WAR_3	每周五20:00—20:30，每3个军团分为一组进行第一轮比赛，第一轮积分最高的9个军团晋级第二轮。	20:00 – 20:30 thứ 6 hàng tuần, hồi 1: mỗi đội 3 Quân Đoàn tranh bá, 9 Quân Đoàn điểm cao nhất được vào hồi 2
HELP_LEGION_WAR_4	每周六20:00—20:30，每3个军团分为一组进行第二轮比赛，第二轮积分最高的3个军团将于周日20:00—20:30,进行第三轮最终战。	20:00 – 20:30 thứ 7 hàng tuần, hồi 2: mỗi đội 3 Quân Đoàn tranh bá, 3 Quân Đoàn điểm cao nhất được vào hồi 3 đấu chung kết vào 20:00 - 20:30 chủ nhật
HELP_LEGION_WAR_5	每场比赛结束，军团将根据战场排名奖励<font color='#00FF00'>军团经验</font>、<font color='#00FF00'>科技令</font>，和参战成员将根据积分奖励<font color='#00FF00'>军团贡献</font>、<font color='#00FF00'>经验人偶</font>。	Sau mỗi trận, Quân Đoàn sẽ nhận được <font color='#00FF00'>Exp Quân Đoàn</font>, <font color='#00FF00'>Khoa Kỹ Lệnh</font>, thành viên Quân Đoàn sẽ nhận được <font color='#00FF00'>Quân Đoàn cống hiến</font>, <font color='#00FF00'>vật phẩm Exp</font>
HELP_LEGION_WAR_6	获得第三轮胜利的军团将占领皇城，其军团长将登基为<font color='#00FF00'>皇帝</font>，享有至尊属性加成。副军团长将册封为<font color='#00FF00'>将军</font>、<font color='#00FF00'>宰相</font>享有高额属性加成，属性加成持续一周。	Quân Đoàn chiến thắng cả 3 hồi sẽ chiếm lĩnh Hoàng Thành, Quân Đoàn trưởng đăng cơ <font color='#00FF00'>Hoàng Đế</font>, Quân Đoàn phó phong thành <font color='#00FF00'>Đại Tướng</font>, <font color='#00FF00'>Thừa Tướng</font> (tùy vào chức vị mà cộng thêm thuộc tính duy trì trong 1 tuần)
HELP_LEGION_WAR_7	在战场中，三个军团各自占据一方主城和附城，成都的的附城为汉中，许昌的附城为赤壁，江陵的附城为荆州。在<font color='#00FF00'>主城</font>受到攻击时，<font color='#00FF00'>攻击+100%加成</font>；在自己<font color='#00FF00'>附城</font>受到攻击或攻击自己附城内的敌人时，<font color='#00FF00'>攻击+80%</font>。	Trong chiến trường, 3 Quân Đoàn sẽ chiếm lĩnh 3 chủ thành (mỗi chủ thành có 1 phụ thành), Hán Trung – Xích Bích – Kinh Châu là phụ thành của Thành Đô – Hứa Xương – Giang Lăng. Tại <font color='#00FF00'>chủ thành</font> công kích tăng <font color='#00FF00'>80%</font>, tại <font color='#00FF00'>phụ thành</font> công kích tăng <font color='#00FF00'>50%</font>.
HELP_LEGION_WAR_8	每次迁徙消耗1点行动力，只能向未被敌对军团占据的相邻城池迁徙。	Tiêu hao 1 điểm hoạt lực để di chuyển đến thành của Quân Đoàn lân cận mà chưa bị kẻ thù chiếm
HELP_LEGION_WAR_9	每次主动攻击消耗1点行动力。	Tiêu hao 1 điểm hoạt lực để tấn công
HELP_LEGION_WAR_10	行动力为0后将无法攻击或迁徙，行动力会随时间恢复，也可花费元宝购买。	Hoạt lực hồi theo thời gian hoặc dùng KNB để mua
HELP_LEGION_WAR_11	击杀和自己等级相近或高于自己的敌人将获得大量积分，击杀低等级敌人只能获得少量积分。	Điểm nhận được khi đánh bại kẻ thù cấp thấp sẽ ít hơn kẻ thù có cấp gần bằng hoặc cao hơn mình
HELP_LEGION_WAR_12	如果连续不死一直击杀其他玩家则为军团战<font color='#00FF00'>连斩</font> ,随着<font color='#00FF00'>连斩</font>次数的增加，每击杀一个其他玩家所获得的积分数也会增加。	Liên tục bất bại sẽ tính thêm điểm <font color='#00FF00'>liên trảm</font>, số <font color='#00FF00'>liên trảm</font> càng cao thì điểm càng nhiều
HELP_LEGION_WAR_13	7座城池每隔一段时间刷出<font color='#00FF00'>怪物</font>，只有城内的玩家才可挑战，击杀后可获得积分奖励。（击杀主城的怪物还会额外获得BUFFER效果。）	Trong 7 thành, mỗi khoảng thời gian sẽ xuất hiện <font color='#00FF00'>Phiến Quân</font> chỉ có thể đánh bại bởi người chơi trong thành, khi Phiến Quân bị đánh bại người chơi sẽ nhận điểm thưởng và chủ thành được chúc phúc
HELP_LEGION_WAR_14	军团积分等于所有成员的积分总和，战场结束时积分最高的军团将获得胜利。	Điểm Quân Đoàn bằng tổng điểm thành viên. Khi kết thúc, Quân Đoàn có điểm cao nhất sẽ chiến thắng
HELP_LEGION_WAR_15	每场军团战开始，玩家首次进入军团战时，自动获得满体力。	Mỗi trận Quân Đoàn chiến, người chơi lần đầu tiên vào được đầy thể lực
HELP_LEGION_WAR_16	每次PVP战斗会消耗体力，单次PVP战斗中损血量越高消耗体力越多。且每次PVP战斗至少消耗10点体力。	Mỗi lần chiến đấu tiêu hao ít nhất 10 điểm thể lực, lượng máu mất càng cao tiêu hao thể lực càng nhiều
HELP_LEGION_WAR_17	击杀各个城池中的怪物时，不扣除体力。	Chiến đấu với Phiến Quân trong thành không bị tiêu hao thể lực
HELP_LEGION_WAR_18	体力消耗为0后即角色死亡，玩家角色会自动返回自己主城，玩家可通过自己主城中的复活功能复活角色。	Khi người chơi tử vong, thể lực về 0 và trở về chủ thành. Thông qua chủ thành để hồi phục thể lực
HELP_LEGION_WAR_19	每场军团战玩家可免费复活2次，之后需要花费元宝复活，每次复活玩家的体力值恢复到上限。	Mỗi trận Quân Đoàn chiến, có 2 lần miễn phí hồi phục thể lực tối đa. Từ lần 3 sẽ tốn KNB
HELP_LEGION_1	军团祈福消耗军团贡献<img src='uires/ui_2nd/com/panel/army_war/gong_ico.png'/>,可产出<font color='#00FF00'>5级宝石</font>。	Cầu phúc tiêu hao cống hiến <img src='uires/ui_2nd/com/panel/army_war/gong_ico.png'/>, có thể nhận được <font color='#00FF00'>Ngọc cấp 5</font>
HELP_LEGION_2	使用军团贡献<img src='uires/ui_2nd/com/panel/army_war/gong_ico.png'/>可在军团商店中兑换道具。	Đổi cống hiến <img src='uires/ui_2nd/com/panel/army_war/gong_ico.png'/> lấy vật phẩm tại Tiệm Quân Đoàn
HELP_LEGION_3	通过军团捐献<img src='uires/ui_2nd/com/panel/army_war/donate_icon.png'/>可获得军团贡献<img src='uires/ui_2nd/com/panel/army_war/gong_ico.png'/>。	Thông qua Quân Đoàn quyên góp <img src='uires/ui_2nd/com/panel/army_war/donate_icon.png'/> để nhận cống hiến Quân Đoàn <img src='uires/ui_2nd/com/panel/army_war/gong_ico.png'/>
HELP_LEGION_4	参加军团战可获得军团贡献<img src='uires/ui_2nd/com/panel/army_war/gong_ico.png'/>。	Tham gia Quân Đoàn chiến cũng có thể nhận cống hiến Quân Đoàn <img src='uires/ui_2nd/com/panel/army_war/gong_ico.png'/>
HELP_LEGION_5	军团科技可提升所有军团成员的能力。	Khoa Kỹ tăng thuộc tính cho tất cả Võ Tướng của thành viên Quân Đoàn
HELP_LEGION_6	军团科技界面中显示军团当前拥有的科技令<img src='uires/ui_2nd/com/panel/legion/science_stone.png'/>数量，军团长和副军团长可使用军团拥有的科技令升级军团科技。	Xem số lượng Khoa Kỹ Lệnh <img src='uires/ui_2nd/com/panel/legion/science_stone.png'/>  tại giao diện Quân Đoàn. Quân Đoàn trưởng hoặc phó có thể dùng Khoa Kỹ Lệnh để tăng cấp Khoa Kỹ
HELP_LEGION_7	在部分特殊活动中可获得科技令<img src='uires/ui_2nd/com/panel/legion/science_stone.png'/>，军团成员可捐献科技令<img src='uires/ui_2nd/com/panel/legion/science_stone.png'/>获得军团贡献，同时所在军团会获得对应数量的科技令<img src='uires/ui_2nd/com/panel/legion/science_stone.png'/>。	Khoa Kỹ Lệnh <img src='uires/ui_2nd/com/panel/legion/science_stone.png'/> có được từ hoạt động, thành viên có thể quyên góp Khoa Kỹ Lệnh <img src='uires/ui_2nd/com/panel/legion/science_stone.png'/> để nhận cống hiến, Khoa Kỹ Lệnh <img src='uires/ui_2nd/com/panel/legion/science_stone.png'/> của Quân Đoàn tăng tương ứng với số lượng quyên góp
HELP_LEGION_8	军团战每一轮前三名的军团可分别获得2——6个科技令<img src='uires/ui_2nd/com/panel/legion/science_stone.png'/>。	Sau mỗi trận Quân Đoàn chiến, Quân Đoàn có hạng 1 – 3 nhận được 2 – 6 Khoa Kĩ Lệnh <img src='uires/ui_2nd/com/panel/legion/science_stone.png'/>
HELP_LEGION_9	普通军团活动每日凌晨0：00刷新。	0 giờ hằng ngày sẽ làm mới
HELP_LEGION_10	皇城争霸相关特殊说明见皇城争霸中的指南说明。	Hoạt động Hoàng Thành Tranh Bá xem hướng dẫn để biết thêm thông tin
HELP_LEGION_11	点击军团界面左上角的军团图标进入军团信息界面。	Ấn vào biểu tượng Quân Đoàn ở góc trái phía trên của giao diện Quân Đoàn để xem thông tin
HELP_LEGION_12	军团信息界面中可进行退出军团的操作。	Trong giao diện thông tin Quân Đoàn có nút thoát khỏi Quân Đoàn
HELP_LEGION_13	军团成员完成每日活跃度可增加军团经验。	Thành viên hoàn thành hoạt động của Quân Đoàn để tăng Exp cho Quân Đoàn
HELP_LEGION_14	军团长可在军团信息界面进行军团信息的修改操作。	Có thể sửa thông tin Quân Đoàn tại giao diện thông tin Quân Đoàn
E_STR_PVP_WAR_DESC1	%d区	Server %d
E_STR_PVP_WAR_DESC2	武圣争霸数据异常	Dữ liệu Võ Thánh Tranh Bá bất thường
E_STR_PVP_WAR_DESC3	%d-%d名	Hạng %d - %d
E_STR_PVP_WAR_DESC4	%d名之后	Dưới hạng %d
E_STR_PVP_WAR_DESC5	%d进%d	%d thành %d
E_STR_PVP_WAR_DESC6	很遗憾你止步于%d进%d，请下届继续努力	Thật đáng tiếc, ngươi đã dừng chân tại %d thành %d, hãy cố gắng hơn vào lần sau 
E_STR_PVP_WAR_DESC7	您正在比赛中，加油哦	Bạn đang thi đấu đấy, cố lên nhé
E_STR_PVP_WAR_DESC8	很遗憾你没有进入决赛，请下届继续努力	Thật đáng tiếc, ngươi không vào được chung kết, hãy cố gắng hơn vào lần sau
E_STR_PVP_WAR_DESC9	战斗尚未开始	Chiến đấu vẫn chưa bắt đầu
E_STR_PVP_WAR_DESC10	恭喜你荣获冠军，成为三国武圣！	Chúc mừng ngươi đã trở thành Quán quân, trở thành Tam Quốc Võ Thánh !
E_STR_PVP_WAR_DESC11	决赛期间无法查看战斗记录	Trong lúc diễn ra chung kết không thể xem chiến báo
E_STR_PVP_WAR_DESC12	本服参赛人数已满，未获得参赛资格	Số lượng tham chiến đã đầy, chưa nhận được tư cách tham chiến
E_STR_PVP_WAR_DESC13	未获得参战资格，无法查看	Chưa nhận được tư cách tham chiến, không thể xem
E_STR_PVP_WAR_DESC14	报名人数不足32人，决赛无法开启	Số người báo danh không đủ 32 người, chung kết không thể bắt đầu
E_STR_PVP_WAR_DESC15	距离我的下一场比赛开始还有	Khoảng cách bắt đầu vòng thi sau của tôi vẫn còn
E_STR_PVP_WAR_DESC16	距离下一场战斗开始还有	Khoảng cách bắt đầu vòng thi sau vẫn còn
E_STR_PVP_WAR_DESC17	比赛即将开始，请做好准备！	Cuộc thi sắp bắt đầu, hãy chuẩn bị !
E_STR_PVP_WAR_DESC18	武圣争夺战即将开始，请做好准备！	Võ Thánh Tranh Bá sắp bắt đầu, hãy chuẩn bị !
E_STR_PVP_WAR_DESC19	第%d场	Trận %d
E_STR_PVP_WAR_DESC20	决赛	Trận chung kết
E_STR_PVP_WAR_DESC21	非决赛期间不能查看人物信息	Chưa phải chung kết không thể xem thông tin nhân vật
E_STR_PVP_WAR_TIME_DESC1	距离我下一场比赛开始还有	Khoảng cách bắt đầu trận đấu kế tiếp của ta còn
E_STR_PVP_WAR_TIME_DESC2	距离下一场比赛开始还有	Khoảng cách bắt đầu trận đấu kế tiếp còn
E_STR_PVP_WAR_WU	无	Không
E_STR_PVP_WAR_AWARDS_DESC1	每日奖励	Quà ngày
E_STR_PVP_WAR_AWARDS_DESC2	排名奖励	Phần thưởng
E_STR_PVP_WAR_AWARDS_DESC3	4强竞猜	Dự đoán Tứ Cường
E_STR_PVP_WAR_AWARDS_DESC4	武圣竞猜	Dự đoán Võ Thánh
E_STR_PVP_WAR_MATCH_DESC	今日免费次数已用完，是否花费%d元宝继续更换对手？	Đã dùng hết số lần miễn phí hôm nay, đồng ý dùng %d KNB tiếp tục đổi đối thủ?
E_STR_TOKEN	荣誉令牌	Lệnh Bài Vinh Dự
E_STR_PVP_OPEN_LEVEL	武圣争霸40级开放	Võ thánh tranh bá cấp 40 mở
E_STR_PVP_WAR_BATTLE_TIMES	今天剩余%d次免费挑战次数	Khiêu chiến hôm nay còn: %d lần
E_STR_PVP_WAR_MATCH_TIMES	今天剩余%d次免费匹配次数	Đổi đối thủ còn: %d lần
E_STR_PVP_WAR_CANNOT_FIGHT	当前尚未匹配对手，无法战斗	Hiện tại chưa có đối thủ phù hợp, không thể chiến đấu
E_STR_PVP_KNOCKOUT_DESC1	每个小组只能支持一人，是否支持此玩家？	Mỗi đội chỉ cần 1 người ủng hộ, đồng ý ủng hộ người chơi này?
E_STR_PVP_SUPPORT_SUCCESS	支持成功	Ủng hộ thành công
E_STR_PVP_REVENGE_INFO	复仇只能进攻一次，且会消耗一次免费挑战次数。是否现在发起复仇进攻	Phục thù chỉ có 1 lần, tốn 1 lần khiêu chiến. Tấn công
E_STR_PVP_MAIN_HELP_DESC1	武圣争霸赛每周举办一次，主公将与其他服务器的多名玩家一起竞技，争夺代表三国最高荣誉和实力的武圣称号。	Võ Thánh Tranh Bá mỗi tuần tổ chức 1 lần, Chủ Công sẽ cùng với nhiều người chơi ở máy chủ khác cạnh tranh, đại diện Tam Quốc vinh dự và thực lực cao nhất tranh đoạt xưng hiệu Võ Thánh 
E_STR_PVP_MAIN_HELP_DESC2	玩家进入活动时，根据其进入时的战斗力获得一个初始积分，战斗力越高，获得的初始积分也就越高。	Căn cứ lực chiến mà nhận được số điểm ban đầu, lực chiến càng cao thì số điểm ban đầu nhận được càng cao
E_STR_PVP_MAIN_HELP_DESC3	活动分为两个阶段，周一到周五为积分排位赛，周六日为决赛阶段。排位赛每周一凌晨00:00开始，排位赛期间，玩家通过匹配与其他玩家进行战斗，胜利获得积分，失败扣除积分。	Sự kiện chia làm 2 giai đoạn, thứ 2 - thứ 6 là tính Điểm vòng loại, thứ 7 - cn là giai đoạn chung kết. Trong thời gian vòng loại, chiến đấu với người chơi khác thắng sẽ nhận được Điểm, thua sẽ bị trừ Điểm
E_STR_PVP_MAIN_HELP_DESC4	排位赛周五晚上24:00结束，根据最终积分高低决定排名（同积分情况下以进入活动先后顺序排名），积分排名前32的玩家获得进入周六日的阶段阶段比赛的资格，争夺武圣称号。若排位赛参赛玩家不超过32位，则决赛无法开启。	Vòng loại kết thúc vào 0 giờ tối thứ 6, căn cứ Điểm cuối cùng để xếp hạng (nếu bằng điểm sẽ xếp hạng theo thứ tự bước vào sự kiện), 32 hạng đầu được vào giai đoạn chung kết (thứ 7 - cn), tranh đoạt danh hiệu Võ Thánh
E_STR_PVP_MAIN_HELP_DESC5	每个玩家每天有10次免费挑战次数和50次免费更换匹配对象的机会。免费次数使用完后，需要消耗元宝才能再次匹配和挑战。	Mỗi người chơi có 10 lần khiêu chiến và 50 lần thay thế đối thủ miễn phí mỗi ngày. Sau khi dùng hết số lần miễn phí, cần tiêu hao KNB mới có thể đổi đối thủ và khiêu chiến lần nữa.
E_STR_PVP_MAIN_HELP_DESC6	主动挑战其他玩家可以获得荣誉令牌，荣誉令牌可以用来在令牌商城兑换道具。荣誉令牌只能通过主动挑战获得，被动防守无法获得荣誉令牌。	Chủ động khiêu chiến người chơi khác có thể nhận được Lệnh Bài Vinh Dự dùng để đổi vật phẩm tại Thương Thành. Lệnh Bài Vinh Dự chỉ nhận được thông qua chủ động khiêu chiến, phòng thủ không nhận được Lệnh Bài Vinh Dự
E_STR_PVP_MAIN_HELP_DESC7	称号获取规则请参照排行榜。	Vui lòng truy cập BXH để xem quy tắc xưng hiệu
E_STR_PVP_KNOCKOUT_HELP_DESC1	决赛参赛选手为排位赛积分排名前32名玩家，进入决赛后随即分成4个小组进行比赛。	Tham gia chung kết là người chơi xếp 32 hạng đầu của vòng loại, chia thành 4 bảng tiến hành thi đấu
E_STR_PVP_KNOCKOUT_HELP_DESC2	决赛分为两日进行，周六进行小组赛，决出每个小组头名进入4强参加周日的武圣争夺战决赛。	Chung kết tiến hành trong 2 ngày, thứ 7 4 bảng tiến hành thi đấu, chọn ra 4 người mạnh nhất của mỗi bảng tham gia quyết chiến Võ Thánh Tranh Bá vào chủ nhật
E_STR_PVP_KNOCKOUT_HELP_DESC3	周六比赛在下午14:00开始，将32名玩家分成4个小组，通过3轮小组赛决出每个小组冠军进入周日的4强赛。	Cuộc thi bắt đầu vào thứ 7 14:00 giờ, 32 người chơi chia thành 4 bảng, sau 3 lượt đấu sẽ chọn ra quán quân của mỗi đội bước vào chung kết vào ngày chủ nhật
E_STR_PVP_KNOCKOUT_HELP_DESC4	比赛时，每轮比赛间隔30分钟，采用5局3胜制，每局比赛间隔5分钟。每轮比赛的胜者晋级下一轮比赛。周六经过三轮比赛决出每个小组冠军，进入周日的决赛。	Khi thi đấu, mỗi hồi thi cách nhau 30 phút, sử dụng chế độ 5 trận thắng 3, mỗi trận thi đấu cách nhau 5 phút. Người thắng của mỗi trận sẽ tiến vào trận tiếp theo. Thứ 7, sau 3 lượt chọn ra được Quán Quân của mỗi bảng, đấu chung kết vào chủ nhật
E_STR_PVP_KNOCKOUT_HELP_DESC5	决赛在周日下午14:00开赛，间隔时间与周六小组赛相同，通过2轮比赛决出最终的冠军。	Chung kết bắt đầu lúc 14:00 chủ nhật, thời gian cách nhau giống như thi đấu tiểu đội ngày 7, trải qua 2 hồi thi chọn ra Quán Quân cuối cùng.
E_STR_PVP_KNOCKOUT_HELP_DESC6	每一轮被淘汰的选手，在当前档次中按照积分高低进行排名，积分越高，排名越前。	Người chơi bị loại sau mỗi hồi thi, căn cứ Điểm tiến hành xếp hạng, Điểm càng nhiều thì xếp hạng càng cao
E_STR_PVP_KNOCKOUT_HELP_DESC7	小组赛和4强赛开始前，玩家可以进行4强名单和武圣竞猜，竞猜没有消耗，竞猜成功后可以获得竞猜奖励。	Trước khi bắt đầu cuộc thi các bảng và tứ cường, người chơi có thể tiến hành dự đoán, dự đoán không tốn gì cả, nếu dự đoán thành công sẽ nhận được phần thưởng
E_STR_PVP_KNOCKOUT_HELP_DESC8	决赛结束后，根据最终的武圣排名发放奖励。排名靠前的玩家可以获得特别丰厚的奖励。同时，根据上一周的最终排名，在下一周周一到周五期间，每天还会根据玩家上周所获得的称号发放每日俸禄奖励。	Căn cứ xếp hạng cuối cùng phát phần thưởng. Xếp hạng cao nhận được phần thưởng lớn. Đồng thời, căn cứ xếp hạng cuối cùng của tuần trước, trong thời gian thứ 2 đến thứ 6 tuần kế tiếp, mỗi ngày nhận thưởng dựa theo xưng hiệu nhận được
E_STR_PVP_KNOCKOUT_HELP_DESC9	只要参加了武圣争霸赛的玩家，不论排名如何，在活动结束后均会获得称号和对应奖励。	Hễ người chơi nào đã tham gia cuộc thi Võ Thánh Tranh Bá, không cần biết xếp hạng ra sao, khi sự kiện kết thúc đều nhận được danh hiệu và phần thưởng tương ứng
E_STR_PVP_MY_QUIZ_HELP_DESC1	决赛阶段的比赛中，玩家可以进行竞猜，支持自己看中的选手争夺小组第一和最终的武圣称号。	Trong giai đoạn chung kết, người chơi có thể tiến hành dự đoán, ủng hộ cho Quân Chủ tranh đoạt danh hiệu Võ Thánh mà mình yêu thích
E_STR_PVP_MY_QUIZ_HELP_DESC2	小组赛开始前，可以在每个小组中选择一名玩家支持其争夺小组冠军，每个小组只能选择支持一名玩家，且一旦选择后无法更改。最多可以支持4个小组的4名玩家。	Trước khi bắt đầu vòng đấu bản, có thể chọn 1 người chơi ủng hộ tranh đoạt Quán Quân, mỗi bảng chỉ được chọn ủng hộ một người chơi, và sau khi chọn không thể đổi. Nhiều nhất có thể ủng hộ 4 người chơi ở 4 bảng
E_STR_PVP_MY_QUIZ_HELP_DESC3	小组赛开始后，便无法再进行小组赛竞猜。小组赛结束后，在4强战开始前，可以进行最终冠军竞猜。	Sau khi bắt đầu vòng đấu bảng, sẽ không thể tiến hành dự đoán. Sau khi kết thúc vòng thi đó, trước khi bắt đầu vòng thi top 4, có thể tiến hành dự đoán Quán Quân cuối cùng
E_STR_PVP_MY_QUIZ_HELP_DESC4	冠军竞猜时，只能支持一位玩家竞争武圣称号，且支持后无法更改。	Khi dự đoán Quán Quân, chỉ cho phép dự đoán một người nhận danh hiệu Võ Thánh, và sau đó sẽ không thể đổi
E_STR_PVP_MY_QUIZ_HELP_DESC5	玩家每成功竞猜一次，则可以领取一份竞猜奖励。多次竞猜成功，则可以领取多份竞猜奖励。	Người chơi mỗi lần dự đoán thành công, sẽ được nhận 1 phần thưởng dự đoán. Nhiều lần dự đoán thành công, sẽ nhận được nhiều phần thưởng
E_STR_PVP_MY_QUIZ_HELP_DESC6	竞猜成功后，下次进入活动界面时自动发放竞猜奖励。奖励发放时，将当前所有竞猜奖励一次性发放。	Sau khi dự đoán thành công, lần sau vào giao diện dự đoán sẽ tự động phát phần thưởng. Khi phát phần thưởng, sẽ cùng phát 1 lúc các phần thưởng trước đó
E_STR_PVP_MY_REPORTS_HELP_DESC1	我的战绩用于显示参加了32强战斗的玩家的战斗记录。	Chiến báo lưu lại lịch sử các trận chiến của 32 người chơi mạnh nhất
E_STR_PVP_MY_REPORTS_HELP_DESC2	每条记录显示每一场战斗的对手和自己的战斗结果。	Mỗi chiến báo sẽ hiển thị đối thủ và kết quả chiến đấu của bản thân sau mỗi trận đấu
E_STR_PVP_MY_REPORTS_HELP_DESC3	在同一轮比赛中，会有多场战斗记录。	Trong cùng 1 hồi thi, sẽ có nhiều chiến báo
E_STR_PVP_MY_REPORTS_HELP_DESC4	战绩记录截止到玩家被淘汰为止时所发生的所有战斗。	Chiến báo sẽ ghi lại hết tất cả các trận chiến của người chơi cho đến khi bị loại
E_STR_PVP_RULE_HELP_DESC1	称号是武圣争霸活动中特有的奖励	Danh hiệu là phần thưởng đặc biệt có được từ sự kiện Võ Thánh Tranh Bá
E_STR_PVP_RULE_HELP_DESC2	每周的活动中，决赛结束后，将根据最终的玩家排名发放称号	Trong sự kiện mỗi tuần, sau khi kết thúc chung kết, sẽ căn cứ vào xếp hạng cuối cùng của người chơi để phát tặng danh hiệu
E_STR_PVP_RULE_HELP_DESC3	称号发放后自动附加给玩家，在下一周活动中玩家可以享受称号带来的特权	Sau khi phát tặng, danh hiệu sẽ tự động gắn vào người chơi, trong sự kiện tuần tiếp theo người chơi có thể hưởng các đặc quyền mà danh hiệu mang lại
E_STR_PVP_RULE_HELP_DESC4	玩家获得称号后，在下一周周一到周五期间，可以在每一次进入活动时，领取称号对应的日常俸禄，称号越高级，可以获得的日常俸禄也就越好	Sau khi người nhận được danh hiệu, trong thứ 2 đến thứ 6 tuần kế tiếp, trong mỗi lần bước vào sự kiện, có thể nhận bổng lộc hằng ngày tương ứng với danh hiệu, danh hiệu càng cao thì bổng lộc nhận được sẽ càng cao
E_STR_FB_URL	https://www.facebook.com/menhthientu.negabox	https://www.facebook.com/menhthientu.negabox
E_STR_GAME_URL	http://www.menhthientu.com/	http://www.menhthientu.com/
E_STR_DESTINY_WHEEL_INFO	x8<font color='#00FF00'>，将额外获赠</font>  <font color='#FF0000'>%s</font>	x 8, <font color='#00FF00'>sẽ được nhận thêm </font> <font color='#FF0000'>%s</font>
E_STR_SETTING_TITLE	稟報督軍	Liên Hệ
E_STR_SETTING_INFO	稟報督軍規則說明：<br/>1.將督軍加入您的 LINE 好友<br/>督軍成功加入為您的 LINE 好友後，即可利用以下按鈕『立馬開始稟報』，與督軍對話進行戰情回報。<br/>督軍 LINE ID：MOFUN_SERVICE<br/>2.可稟報督軍的時間為：每日 10:00 ~ 23:00 非稟報時間請使用飛鴿傳書回報戰情即可。<br/>督軍位置：【MDCAPP_SERVICE@MO-FUN.COM.TW】	Trang chủ: http://www.menhthientu.com/<br/>Fanpage: https://www.facebook.com/menhthientu.negabox<br/>Email: info@menhthientu.com<br/>Số điện thoại: 08 6685 2781
E_STR_SENDTO_LINE	我是【夢貂蟬APP】的玩家，我的角色名稱是『%s』，ID是『%s』，我有重要戰情要立馬稟報督軍。	Tôi là người chơi của [Mộng Điêu Thuyền APP] , tên nhân vật của tôi là [%s], ID là [%S], tôi có tình chiến quan trọng cần bẩm báo Đốc quân
E_STR_SETTING_BUT_TX	<img src='uires/ui_2nd/com/panel/systemseting/line.png'/>立馬開始稟報	OK
E_STR_LOGIN_FAILED	登陆失败，请重试。	Đăng nhập thất bại, hãy thử lại
E_STR_LAST_TIME_TODAY	今天%s	Hôm nay %s
E_STR_LAST_TIME_YESTERDAY	昨天%s	Hôm qua %s
E_STR_LAST_TIME_BEFORE_YESTERDAY	前天%s	Hôm kia %s
E_STR_LAST_TIME_THREE_DAY	三天前	3 ngày trước
E_STR_LAST_TIME_WEEK	一周前	tuần trước
E_STR_PAYCARNIVAL_UNFINISHED	<img src='uires/ui_2nd/com/panel/common/cash_icon.png'/>%s/%s	<img src='uires/ui_2nd/com/panel/common/cash_icon.png'/> %s/%s
E_STR_PAYCARNIVAL_FINISHED	<img src='uires/ui_2nd/com/panel/common/cash_icon.png'/>已达成	<img src='uires/ui_2nd/com/panel/common/cash_icon.png'/> đạt đến
E_STR_PAYCARNIVAL_RECHARGE_EXPLAIN	当日累计充值<img src='uires/ui_2nd/com/panel/common/cash_icon.png'/>满%d即可在以下四种礼包中选取一种获得奖励，同时开启持续%d天的消费礼包，点击礼包即刻领取。	Trong ngày nạp <img src='uires/ui_2nd/com/panel/common/cash_icon.png'/> đủ %d, có thể chọn 1 trong 4 hình thức lễ bao để nhận thưởng 
E_STR_PAYCARNIVAL_EXPEND_EXPLAIN	每日消费满<img src='uires/ui_2nd/com/panel/common/cash_icon.png'/>%d即可在以下四种礼包中选取一种获得奖励，VIP达到要求更可以享受双倍奖励，点击礼包即刻领取。剩余: %d天	Mỗi ngày tiêu <img src='uires/ui_2nd/com/panel/common/cash_icon.png'/> đủ %d, có thể chọn 1 trong 4 hình thức lễ bao để nhận thưởng, cấp VIP đạt yêu cầu sẽ nhận thưởng gấp 2. Ấn vào lễ bao nhận ngay. Còn lại %d ngày  
E_STR_PAYCARNIVAL_VIP_DOUBLE	VIP%d双倍	VIP %d gấp 2
HELP_PAYCARNIVAL_1	达成充值条件当日，请及时领取奖励并开启七日奖励。	Đạt điều kiện Nạp trong ngày, hãy nhận ngay phần thưởng và mở phần thưởng tiêu 7 ngày
HELP_PAYCARNIVAL_2	七日奖励开启后不间断持续七天，每天0点重置。七天重置刷新后可再次开启充值嘉年华。	0 giờ hằng ngày thiết lập lại phần thưởng tiêu 7 ngày. Sau 7 ngày tiêu sẽ mở lễ hội nạp lần nữa .
HELP_PAYCARNIVAL_3	活动期间，每日消耗元宝达到特定金额，可领取奖励礼包。VIP等级达到相应要求还可领取双倍奖励。每天请及时领取奖励，逾期作废。	Trong thời gian sự kiện, mỗi ngày tiêu hao lượng KNB nhất định sẽ nhận được lễ bao. Cấp VIP đạt yêu cầu tương ứng còn nhận được phần thưởng gấp 2. Hãy kịp thời nhận thưởng mỗi ngày, quá hạn bị hủy bỏ 
HELP_PAYCARNIVAL_4	达到活动开启条件当日请及时领取奖励，每天0点重置后，充值元宝计数将会清空。需重新达到活动开启条件，方能开启活动。	Đạt đủ điều kiện sự kiện trong ngày mời nhanh chóng nhận phần thưởng, mỗi ngày 0 giờ thiết lập lại, tổng tích lũy KNB nạp sẽ được xóa sạch. Cần phải đạt điều kiện từ đầu của sự kiện, sự kiện mới được mở 
HELP_PAYCARNIVAL_5	每日消耗元宝奖励档次分为240元宝、480元宝、840元宝三个档次，请各位主公不要错过。	Phần thưởng tiêu hao KNB mỗi ngày được chia thành 240 KNB, 480 KNB, 840 KNB, các vị Chủ Công đừng bỏ lỡ nhé 
E_STR_PAYCARNIVAL_ALREADY	今日礼包已领取成功，请明日再来领取	Hôm nay đã nhận thành công lễ bao, mời ngày mai quay lại nhận tiếp nhé
E_STR_PAYCARNIVAL_EXPEDN_NOTENOUGH	消费元宝未达到要求不能领取奖励	Tiêu phí KNB chưa đạt yêu cầu không thể nhận thưởng
E_STR_PAYCARNIVAL_RECHARGE_NOTENOUGH	充值元宝未达到要求不能领取奖励	Nạp KNB chưa đạt đến chỉ tiêu không thể nhận phần thưởng 
E_STR_PAYCARNIVAL_INFO	点击领奖，确认领取<font color='#FF0000'>%s</font>礼包	Ấn nhận thưởng, đồng ý nhận <font color='#FF0000'>%s</font> lễ bao 
E_STR_LUCK_RUNNER_INFO	使用物品兑换积分成功后，会扣除背包中相应物品。确定是否兑换？	Sau khi dùng vật phẩm đổi Điểm thành công, sẽ khấu trừ vật phẩm tương ứng trong túi. Đồng ý đổi ?
E_STR_LUCK_RUNNER_CASH	主公，您想花费%d元宝刷新幸运轮盘吗？	Chủ Công, ngươi muốn dùng %d KNB làm mới Hạnh Vận Luân Bàn chứ ?
E_STR_BAG_ITEM_NOT_ENOUGH	背包物品不足	Vật phẩm trong túi không đủ
HELP_HOFMAN_1	活动期间玩家出征或扫荡关卡，有几率掉落新年福娃。	Trong thời gian sự kiện người chơi xuất chinh hoặc càn quét quan ải, có xác suất nhận Tân Niên Phúc Oa 
HELP_HOFMAN_2	活动期间玩家每消耗一个新年福娃可拉动拉杆一次，每天可获得3个新年福娃。	Trong thời gian sự kiện người chơi cứ tiêu hao 1 cái Tân Niên Phúc Oa có thể đẩy cần gạt 1 lần, mỗi ngày có thể nhận được 3 cái Tân Niên Phúc Oa . 
HELP_HOFMAN_3	每次拉动拉杆，玩家将获得显示数字对应数量的元宝，还能领取累计登陆奖励。	Mỗi lần đẩy cần gạt, người chơi sẽ nhận được các con số hiển thị tương ứng với số lượng KNB, còn nhận được tích lũy phần thưởng đăng nhập 
HELP_HOFMAN_4	活动期间福满天下每天0点将会重置，重置后福娃数量将会清零，请及时使用福娃，以免造成遗憾。	Trong thời gian sự kiện Phúc Mãn Thiên Hạ sẽ được làm mới vào 0 giờ mỗi ngày, sau khi làm mới số lượng Phúc Oa sẽ trả lại 0, xin hãy kịp thời sử dụng Phúc Oa, tránh tạo thành sự đáng tiếc .
E_STR_HOFMAN_INFO	每日出征关卡可获得3个新年福娃，使用新年福娃，转动转轮获得显示数字对应元宝数，福娃数量每天0点重置。活动期间还可领取丰厚的累计登陆奖励。	Mỗi ngày xuất chinh quan ải có thể nhận được 3 cái Tân Niên Phúc Oa, sử dụng Tân Niên Phúc Oa, chuyển động vòng quay, người chơi sẽ nhận được các con số hiển thị tương ứng với số lượng KNB, 0 giờ hằng ngày làm mới số lượng Phúc Oa. Trong thời gian sự kiện
E_STR_HOFMAN_TIME	2015年2月18日-2015年2月24日	Ngày 18 tháng 2 năm 2015 - Ngày 24 tháng 2 năm 2015
E_STR_FUWA_NOT_ENOUGH	新年福娃不足，不能抽奖	Tân Niên Phúc Oa không đủ, không thể quay thưởng
E_STR_TODAY_FUWA_END	今日福娃已用完，请明日再来	Đã sử dụng hết Phúc Oa hôm nay, mời ngày mai quay lại
E_STR_FRIENDS_GET_FOOD	收取好友赠送%d粮草	Nhận %d Lúa hảo hữu tặng
E_STR_FRIENDS_GIVE_FOOD	赠送好友每人%d粮草	Tặng hảo hữu mỗi người %d Lúa
E_STR_FRIENDS_APPLY_0	申请成功	Xin phép thành công
E_STR_FRIENDS_APPLY_1	已经在自己的好友列表中	Đã có trong danh sách hảo hữu
E_STR_FRIENDS_APPLY_2	已经在对方的申请好友列表中	Đã có trong danh sách xin phép hảo hữu của đối phương
E_STR_FRIENDS_APPLY_3	自己好友列表已满	Danh sách hảo hữu đã đầy
E_STR_FRIENDS_APPLY_4	对方好友列表已满	Danh sách hảo hữu đối phương đã đầy
E_STR_FRIENDS_APPLY_5	对方已经申请自己，添加好友成功	Đối phương đã xin phép, thêm hảo hữu thành công 
E_STR_FRIENDS_ADD_SUC	好友添加成功	Thêm hảo hữu thành công
E_STR_FRIENDS_DEL_SUC	拒绝好友申请	Từ chối xin phép hảo hữu
E_STR_FRIENDS_FULL	对方好友列表已满	Danh sách hảo hữu đối phương đã đầy
E_STR_FRIENDS_UNKNOW	未知错误，请重启游戏．	Lỗi chưa xác định, thử khởi động lại !
E_STR_FRIENDS_NOT_FOUND	没有找到该玩家	Không tìm được người chơi này
E_STR_CHAT_INTERVAL	放送消息过于频繁，请等待5秒	Tin tức đang quá tải, xin chờ trong 5 giây 
E_STR_UNLOCK_LEGION_CHAT	21级加入军团后，解锁军团聊天	Cấp 21 gia nhập Quân Đoàn, mở khóa Quân Đoàn trò chuyện 
E_STR_CHAT_ADD_FRIEND	加为好友	Thêm hảo hữu
E_STR_CHAT_DEL_FRIEND	删除好友	Xóa hảo hữu
E_STR_CHAT_APPLYING_FRIEND	申请中	Đang xin phép
E_STR_FRIENDS_REMOVE_SUC	删除好友成功	Xóa hảo hữu thành công
E_STR_CONFIRM_REMOVE_FRIEND	确认删除该好友？	Đồng ý xóa hảo hữu này?
LEGION_ALEADY_JOINED_OTHERS	后台数据已发生变更，你已经被申请通过加入军团	Dữ liệu đã cập nhật mới, ngươi đã được thêm vào Quân Đoàn 
LEGION_MEMBER_COUNT	人数  %d/%d	Thành viên %d/%d
E_STR_SHOP_DESC1	%d人购买	%d người mua
E_STR_SHOP_DESC2	返还%d	Trả lại %d
E_STR_SHOP_DESC3	结算倒计时:	Tổng kết còn:
E_STR_SHOP_DESC4	当前尚无返还元宝的订单	Hiện tại không có nhiệm vụ trả lại KNB 
E_STR_SHOP_DESC5	%d月%d日	tháng %d ngày %d 
E_STR_SHOP_DESC6	，请于本期团购结束后领取返还元宝。	 , hãy nhận lại KNB sau khi kết thúc đợt mua theo nhóm này
E_STR_SHOP_DESC7	开始倒计时:	Bắt đầu còn:
E_STR_SHOP_DESC8	未开始	Chưa bắt đầu
E_STR_SHOP_DESC9	恭喜眼明手快的%s成为本期秒杀幸运儿之一，获得了%s。	Chúc mừng %s trở thành người may mắn tranh mua kì này, đã nhận được %s
E_STR_SHOP_DESC10	很遗憾，你慢了一步，期待下期吧。	Thật đáng tiếc, ngươi chậm một bước rồi, đợi lần sau nhé.
E_STR_SHOP_CARD_NAME_DESC1	惊喜不断	Không phải dạng vừa
E_STR_SHOP_CARD_NAME_DESC2	好运连连	Thật tuyệt vời
E_STR_SHOP_CARD_NAME_DESC3	不容错过	Không thể tin được
E_STR_SHOP_SELLALL	已售完	Đã bán hết
E_STR_SHOP_MIAOSHA	秒杀	Tranh mua 
E_STR_SHOP_MIAOSHA1	已秒杀	Đã tranh mua
E_STR_SHOP_DATA_ERR	商城数据已刷新	Dữ liệu Thương Thành đã làm mới
E_STR_SHOP_DATE	%d年%d月%d日	Năm %d tháng %d ngày %d
E_STR_SHOP_MIAOSHA_NOTICE	当前尚无最近秒杀成功名单	Hiện tại không có nhiệm vụ nào tranh mua thành công 
E_STR_SHOP_BLACKSHOP_DESC1	已达刷新次数上限	Số lần làm mới đã đạt giới hạn
E_STR_SHOP_BLACKSHOP_DESC2	刷新所需材料不够,是否使用元宝继续刷新？	Vật phẩm làm mới không có, Dùng KNB làm mới ?
E_STR_SHOP_BLACKSHOP_DESC3	已达刷新次数上限，提升VIP等级可获得额外刷新次数	Số lần làm mới đã hết, tăng cấp VIP có thể thêm
E_STR_SHOP_SHENGWANG_DESC	声望不足	Danh Vọng không đủ 
E_STR_SHOP_HELP_DESC1	特购为VIP特购，VIP达到要求可购买特惠道具，每日可购买1次。	VIP có đặc quyền mua ưu đãi, VIP đạt đủ yêu cầu sẽ có thể mua vật phẩm với giá đặc biệt, mỗi ngày có thể mua 1 lần
E_STR_SHOP_HELP_DESC2	团购每天于0:00、6:00、12:00、18:00开放，一轮6小时，前5小时为购买期，最后1小时为结算期，进入结算期后就无法参加该期团购，请把握时间参与。	Mua theo nhóm hằng ngày được mở vào lúc 0:00, 6:00, 12:00, 18:00, mỗi lần 6 giờ, 5 giờ của thời gian mua, 1 giờ cuối cùng của thời gian tổng kết, bước vào thời gian tổng kết sẽ không thể tham gia mua nữa, hãy nắm bắt thời gian nhé.
E_STR_SHOP_HELP_DESC3	团购商品购买的玩家越多，返还的元宝就越多，点击刷新可即使了解目前购买人数。	Người chơi mua càng nhiều vật phẩm, thì KNB trả lại sẽ càng nhiều, ấn làm mới có thể xem rõ hơn số người mua hiện tại 
E_STR_SHOP_HELP_DESC4	购买时需要按原价付款，每期团购结束后根据购买人数返还相应数量的元宝。	Khi mua sẽ căn cứ vào giá gốc để thanh toán, sau khi kết thúc căn cứ vào số người mua để trả lại KNB tương ứng 
E_STR_SHOP_HELP_DESC5	团购返还的元宝保留30天，过期无法领取，请及时领取。	Mua theo nhóm trả lại KNB được bảo lưu trong 30 ngày, quá hạn sẽ không thể nhận, hãy nhận kịp thời 
E_STR_SHOP_HELP_DESC6	每天11点与21点开启秒杀,每期持续30分钟。	Mỗi ngày vào 11 giờ và 21 giờ bắt đầu tranh mua, mỗi lần duy trì 30 phút 
E_STR_SHOP_HELP_DESC7	秒杀分1折秒杀和1元秒杀，每次开启时随机一种方式。	Tranh mua chia thành tranh mua giảm 90% và tranh mua mua với 1 đồng, mỗi ngày sẽ ngẫu nhiên mở 1 loại 
E_STR_SHOP_HELP_DESC8	每期秒杀提供三种道具，供玩家选择，每种道具仅限购买1次，每次只能选择秒杀一种道具。	Mỗi lần tranh mua sẽ có 3 loại vật phẩm, mỗi loại vật phẩm chỉ được mua 1 lần
E_STR_SHOP_HELP_DESC9	每期秒杀开启后，道具数量有限，先到先得。	Sau mỗi lần bắt đầu tranh mua, số lượng vật phẩm có hạn, đến trước được trước 
E_STR_AVFOOD_FOODEXTRA	领取成功，额外获得%d粮草	Nhận thành công, nhận được thêm %d Lúa
E_STR_AVFOOD_HADGEN	您已经领取过了	Bạn đã nhận rồi
E_STR_AVFOOD_MISSTIME	您错过领取时间了	Bạn đã bỏ lỡ thời gian nhận rồi
E_STR_ARENA_AWARD_DESC1	未达成	Chưa đạt
E_STR_ARENA_AWARD_DESC2	已达成	Đã đạt
E_STR_SKILL_BO	合成暴击！！	Ghép bạo kích !!
E_STR_SKILL_DEBO	超级暴击！！	Siêu cấp bạo kích !!
E_STR_AVPAY_NO_BOX	主公，没有宝箱哦，快去征战获得宝箱吧。	Chủ Công, không có Bảo Rương đấy, mau đi chinh chiến để nhận Bảo Rương thôi 
E_STR_AVPAY_NO_SCORE	主公，开宝箱可是需要100积分的哦。	Chủ Công, mở Bảo Rương cần 100 Điểm đấy nhé 
E_STR_BOSS_ISAUTO	自动战斗	Tự động chiến đấu
E_STR_BOSS_NOTAUTO	取消自动	Hủy bỏ tự động
E_STR_ARENA_HAVE_NOT_ACHIEVE	未达成	Chưa đạt
E_STR_FAME	声望	Danh Vọng 
E_STR_GET_AWARD_BUSINESS	你获得了%s	Bạn nhận được %s
E_STR_FRIENDS_DELETE	确定要删除这个好友吗?	Chắc chắn xóa hảo hữu này chứ?
E_STR_FRIENDS_SEARCH_SELF	请不要搜索自己	Hãy đừng tìm kiếm bản thân
E_STR_SOULXPMAITAL_CONUT	不足！	Không đủ !
E_STR_HEIDIAN_HELP_DESC1	神秘商店是游戏中的特殊商店，可以在其中通过购买获得特殊道具	Tiệm Thần Bí là Tiệm đặc biệt, có thể mua được vật phẩm đặc biệt
E_STR_HEIDIAN_HELP_DESC2	神秘商店中可以获得低价打折商品、彩将招募令、神将碎片等稀缺道具	Tiệm Thần Bí có bán vật phẩm ưu đãi, lệnh chiêu mộ Thần Tướng, Mảnh Phong Thần và các vật phẩm hiếm
E_STR_HEIDIAN_HELP_DESC3	神秘商店中的商品，可以用元宝、将魂、金币等多种方式购买	Vật phẩm trong Tiệm Thần Bí, có thể mua bằng KNB, Tướng Hồn, Vàng,…
E_STR_HEIDIAN_HELP_DESC4	神秘商店每隔2个小时自动刷新一次，每次刷新均会更换出售的商品列表	Tiệm Thần Bí cứ 2 giờ sẽ làm mới 1 lần, mỗi lần làm mới hầu như sẽ đổi danh mục vật phẩm bán 
E_STR_HEIDIAN_HELP_DESC5	主公们可以通过刷新主动更换神秘商店中的商品列表，选择自己想要的物品进行购买	Chủ Công có thể làm mới để đổi danh mục vật phẩm trong Tiệm Thần Bí, chọn vật phẩm mình thích và tiến hành mua nó
E_STR_HEIDIAN_HELP_DESC6	刷新需要消耗刷新令牌或元宝，优先消耗令牌，令牌不足时消耗元宝	Làm mới cần tiêu hao Thương Lệnh hoặc KNB, ưu tiên tiêu hao Thương Lệnh, không đủ sẽ tiêu hao KNB 
E_STR_HEIDIAN_HELP_DESC7	每个主公每天可以获得一定数量的刷新令牌	Mỗi Chủ Công sẽ nhận được số lượng Thương Lệnh nhất định hằng ngày
E_STR_HEIDIAN_HELP_DESC8	每日刷新神秘商店均有上限次数，主公的VIP等级不同，刷新神秘商店的上限次数也有所不同	Hằng ngày làm mới Tiệm Thần Bí đều được giới hạn số lần, cấp VIP khác nhau thì giới hạn số lần làm mới Tiệm Thần Bí cũng sẽ khác
E_STR_ALTAR_FOOD_NOT_ENOUCH	本次挑战需要花费%d元宝，当前元宝不足	Khiêu chiến cần %d Lúa, hiện tại Lúa không đủ 
E_STR_NOTATTHETIME	活动结束后才能领取排行奖励。	Sau khi sự kiện kết thúc mới nhận được phần thưởng xếp hạng
E_STR_BORROWARROW_RESET	重置将扣除%d元宝，是否确定？	Làm mới tốn %d KNB, đồng ý?
E_STR_PVP_NOT_OPEN	本服武圣争霸暂未开放，敬请期待	Võ Thánh Tranh Bá vẫn chưa mở, hãy đợi nhé 
E_STR_GOTO_GET	去获取	Nhận 
E_STR_GOTO	前往	Đi
E_STR_TASK_DESC	活跃度领取物品异常	Nhận thưởng vật phẩm bị lỗi 
E_STR_PATROL_INFO1	1.初始状态下矿点会有一个武将在进行驻守	1. Ban đầu Ngân Khoáng sẽ có Võ Tướng trấn thủ 
E_STR_PATROL_INFO2	2.击败原有驻守武将后，才能派遣武将驻守其中	2. Sau khi đánh bại Võ Tướng trấn thủ hiện tại, mới được cử Võ Tướng trấn thủ khác 
E_STR_PATROL_INFO3	3.击败原有驻守武将时，可获得丰厚奖励	3. Khi đánh bại Võ Tướng trấn thủ hiện tại, có thể nhận được mảnh Võ Tướng tương ứng
E_STR_PATROL_INFO4	4.君主派遣武将驻守矿点，可获得各种游戏道具奖励，若武将可用碎片合成，则一定会获得驻守武将对应的武将碎片	4. Quân Chủ cử Võ Tướng trấn thủ Ngân Khoáng, có thể nhận được phần thưởng phong phú, và sẽ nhận được mảnh Võ Tướng tương ứng
E_STR_PATROL_EXPLANATION1	1.武将进驻矿点后，每隔一段时间获取一次奖励,矿场日志会显示所有的获奖记录	1. Sau khi Võ Tướng vào Điểm Khoáng, cứ cách một lúc được 1 lần thưởng, nhật ký Bãi Khoáng sẽ hiển thị tất cả nhật ký nhận thưởng
E_STR_PATROL_EXPLANATION2	2.获取奖励时，可获得多种道具，有概率得到元宝和驻守武将对应的武将碎片	2. Khi nhận thưởng được các loại đạo cụ, có tỉ lệ được KNB và Mảnh Võ Tướng tương ứng Võ Tướng trấn thủ
E_STR_PATROL_EXPLANATION3	3.驻守期间获得的奖励，只有在驻守结束后才能领取	3. Thưởng thời gian trấn thủ nhận được, chỉ sau khi trấn thủ kết thúc mới nhận được
E_STR_PATROL_EXPLANATION4	4.武将驻守后不影响其他游戏行为	4. Võ Tướng trấn thủ không ảnh hưởng đến các hoạt động khác
E_STR_PATROL_GET_REWARD	驻守获得奖励	Trấn thủ đạt phần thưởng 
E_STR_PATROL_VIEW1	查看说明	Hướng dẫn 
E_STR_PATROL_VIEW2	查看阵型	Trận hình
E_STR_PATROL_WIN_GET	战胜可获得	Chiến thắng sẽ nhận được 
E_STR_PATROL_REWARD_LIMIT	奖励获取已达上限	Nhận thưởng đã đạt giới hạn 
E_STR_PATROL_REWARD_NEXT_TIME	下次奖励获取时间:	Thời gian nhận thưởng lần sau:
E_STR_PATROL_NONE_ROLE	当前无人驻守	Hiện tại không ai trấn thủ 
E_STR_PATROL_REWARD_NOW	当前驻守奖励	Phần thưởng trấn thủ hiện tại 
E_STR_PATROL_REWARD	驻守后概率获得	Sau khi trấn thủ có tỉ lệ nhận được
E_STR_PATROL_HELP1	地图上存在多个矿点，初始时都有一个武将驻守其中	Mỗi bản đồ có nhiều quáng điểm, mỗi quáng điểm đều để cho người chơi cử Võ Tướng trấn giữ 
E_STR_PATROL_HELP2	击败初始的驻守武将后，君主可以派遣自己的武将驻守到矿点中	Mỗi quáng điểm lúc đầu đều có 1 Võ Tướng trấn thủ, sau khi công bại Võ Tướng đó mới được cử Võ Tướng trấn thủ quáng điểm 
E_STR_PATROL_HELP3	挑战矿点的驻守武将时，只有成功挑战战力较低的矿点驻守武将后，才能挑战战力更高的驻守武将。挑战成功后，可以获得丰厚奖励	Quáng điểm có nhiều cấp khác nhau, cấp càng cao,thực lực Võ Tướng trấn thủ càng mạnh; Thực lực Võ Tướng trấn thủ càng mạnh, phần thưởng sau khi công bại sẽ càng  phong phú 
E_STR_PATROL_HELP4	武将驻守矿点期间，每隔一段时间便会获得一次驻守奖励	Chỉ khi công bại Võ Tướng trấn thủ của quáng điểm cấp thấp, mới có cơ hội công đánh quáng điểm cấp cao 
E_STR_PATROL_HELP5	每次获得奖励时，君主都有一定几率获得”金币、培养丹、经验人偶、技能书、兵符、神秘商店刷新令、幸运宝石”，更有一定几率获得元宝和驻守武将对应的武将碎片。 	Sau khi công bại Võ Tướng hiện tại của quáng điểm, Quân chủ có thể cử Võ Tướng của mình để trấn thủ, giám sát quáng sản khai thác
E_STR_PATROL_HELP6	驻守结束后，君主可以一次性领取驻守期间的奖励，但在驻守期间，无法更改驻守的武将名单，且武将也无法撤离	Sau khi trấn thủ kết thúc, Quân Chủ có thể một lần nhận hết phần thưởng trấn thủ, nhưng trong thời gian trấn thủ, không thể đổi danh sách Võ Tướng trấn thủ, và Võ Tướng này cũng không thể rời khỏi 
E_STR_PATROL_HELP7	武将驻守期间，不对武将的其他游戏行为造成影响	Trong thời gian trấn thủ, kkhông thể thao tác Võ Tướng
E_STR_PATROL_HELP8	君主只能派遣上阵中的武将驻守矿点，一个武将同一时刻只能驻守一个矿点	Quân Chủ chỉ được cử Võ Tướng xuất trận để trấn thủ mỏ, một Võ Tướng ở cùng 1 thời điểm chỉ được trấn thủ 1 mỏ
E_STR_PATROL_HELP9	选择驻守时，君主们也可以选择不同的驻守与奖励获得方式，用以对应君主们各自的不同情况	Khi chọn trấn thủ, Quân Chủ có thể chọn các hình thức trấn thủ và phần thưởng khác nhau, tùy vào từng trường hợp tương ứng khác nhau của Quân Chủ 
E_STR_PATROL_END	驻守已结束可领奖	Phần thưởng đã kết thúc khả năng nhận thưởng
E_STR_PATROL_TIME1	%s小时	%s giờ
E_STR_PATROL_TIME2	(每%smin获得一次奖励)	(Cứ %s phút nhận thưởng 1 lần)
E_STR_PATROL_NO_CHIP	此武将无碎片	Võ Tướng này không còn mảnh
E_STR_PATROL_GARRISONED1	该武将已经在驻守其他金矿	Võ Tướng này đã trấn thủ mỏ khác 
E_STR_PATROL_GARRISONED2	已驻守	Đã trấn thủ 
E_STR_EXP_MAX	经验已满	Exp đã đầy
E_STR_STAGE_PANEL_INFO2	主公可以回頭打關卡，得星星，換神將呦~	Chủ Công có thể quay lại đánh quan ải, nhận sao, đổi thần tướng 
E_STR_OPEN_LEVEL	等级不足	Cấp không đủ 
E_STR_SOUL_ALTAR_OPEN_LIMIT	产出尚未开放	Chưa mở 
E_STR_RUN_COUNT	转动次数:	Số lần quay:
E_STR_REMAIN_SCORE	剩余积分:	Điểm còn:
E_STR_LEFT_TIME	活动剩余时间:	Sự kiện còn:
E_STR_RUN_SCORE	转动消耗积分:	Quay tiêu hao điểm:
E_STR_REFRESH_SCORE	刷新消耗积分:	Làm mới tiêu hao điểm:
E_STR_RUN	转动	Quay
E_STR_BORROWARROW_UP_TO_RANK	恭喜主公，我们挺进到第%d名了	Chúc mừng Chủ Công, hiện tại đã vào đến hạng %d rồi 
E_STR_BORROWARROW_DOWN_TO_RANK	有人居然比我们还拼，我们跌到第%d名了	Quả nhiên có người còn lợi hại hơn, chúng ta đã rớt đến hạng %d rồi
E_STR_GOT_CRIT_SCORE	恭喜主公，此发暴击，获得%d积分	Chúc mừng Chủ Công, lần bạo kích này nhận được %d Điểm 
E_STR_GOT_SCORE	获得%d积分	Nhận được %d Điểm 
E_STR_REPLACE_SKILL	更换技能	Đổi kỹ năng 
E_STR_OPEN_SKILL_FIELD	是否花费%d元宝开启该栏位？	Đồng ý dùng %d KNB mở ô ?
E_STR_REPLACE_SKILL_SUCCESS	更换成功	Đổi thành công 
E_STR_SKILL_NOT_OPEN	暂未开放	Chưa mở 
LEGION_MILITARY_EFFECT_INFO	皇城争霸和矿区争夺战中：每次战斗扣除体力值-%d点，初始迁徙次数+%d次。	Ở Hoàng Thành Tranh Bá và Khoáng Thạch Chiến: Mỗi lần chiến đấu -%d điểm thể lực, số lần di chuyển ban đầu + %d lần.
LEGION_MILITARY_GET_EXP_INFO	在皇城称霸中，每击杀一个地方玩家，增加%d点军衔经验	Trong Hoàng Thành Tranh Bá, cứ diệt 1 người chơi, tăng %d điểm EXP Quân Hàm
E_STR_ROLE_HORSE_DESC1	装备%s，额外%s+%s	Trang bị %s, thêm %s + %s
E_STR_ROLE_HORSE_DESC2	装备%s级马鞍，额外%s+%s	Trang bị Yên Ngựa cấp %s, thêm %s + %s
E_STR_ROLE_HORSE_DESC3	装备%s级马鞭，额外%s+%s	Trang bị Roi Ngựa cấp %s, thêm %s + %s
E_STR_ROLE_FATE_DESC	缘分武将	Võ tướng duyên phận
E_STR_ROLE_HORSE_EQUIP	装备于	Trang bị cho
E_STR_ROLE_HORSE_ERR	坐骑信息异常	Thông tin thú cưỡi bất thường
E_STR_ROLE_HORSE_EQUIPED	已装备此马	Đã trang bị ngựa này
E_STR_ROLE_HORSE_NO_EXCHANGE	没有马匹可更换	Không có ngựa để thay đổi
E_STR_ROLE_HORSE_LEVEL	等级：%d/10级	Cấp: %d/10
E_STR_ROLE_HORSE_EQUIP_ROLE	装备武将：	Trang bị Võ Tướng: 
E_STR_ROLE_HORSE_FULL	马厩已满，请出售部分不需要的马匹	Chuồng ngựa đã đầy, bán một số ngựa không cần dùng
E_STR_STRENGTH_MASTER_REACH	[%s]装备强化大师%s级达成	[%s] Cường Hóa Sư đạt cấp %s
E_STR_FORGE_MASTER_REACH	[%s]装备打造大师%s级达成	[%s] Luyện Hóa Sư cấp %s
E_STR_GEM_MASTER_REACH	[%s]装备宝石大师%s级达成	[%s] Khảm Sư đạt cấp %s 
E_STR_ATTACK_BUFF_NUMBER	武力+%d	Võ Lực +%d
E_STR_MAGIC_BUFF_NUMBER	谋略+%d	Mưu Lược+%d
E_STR_HEALTH_BUFF_NUMBER	士兵+%d	Binh Lực +%d
E_STR_DEFENCE_BUFF_NUMBER	武防+%d	Võ Phòng +%d
E_STR_MDEFENCE_BUFF_NUMBER	谋防+%d	Mưu Phòng +%d
E_STR_LEVEL	%d级	Cấp %d
E_STR_LEVEL_MAX	%d级(满级)	Cấp %d (Đủ cấp)
E_STR_STRENGTH_MASTER_INFO	所有装备强化达到%d级则强化大师升级	Cường hóa tất cả trang bị đạt cấp %d sẽ tăng cấp Cường Hóa Sư
E_STR_FORGE_MASTER_INFO	所有装备打造达到%d级则打造大师升级	Rèn tất cả trang bị đạt cấp %d sẽ tăng cấp Luyện Hóa Sư
E_STR_GEM_MASTER_INFO	所有装备镶嵌宝石达到%d级则镶嵌大师升级	Khảm tất cả trang bị đạt cấp %d sẽ tăng cấp Khảm Sư
E_STR_ROLE_HORSE_CONFIRMSELL	选中马匹中有橙色马匹，是否出售	Trong mục chọn ngựa có ngựa cam, bán không
E_STR_HORSE_UP_TITLE1	坐骑升级	Tăng cấp thú cưỡi
E_STR_HORSE_UP_TITLE2	马鞭升级	Tăng cấp Roi Ngựa
E_STR_HORSE_UP_TITLE3	马鞍升级	Tăng cấp Yên Ngựa
E_STR_ACTIVIT_OVER	活动已结束	Hoạt động đã kết thúc
E_STR_AWARD_TOM	请主公次日在来领取奖励！	Chúa công ngày sau đến nhận thưởng!
E_STR_ERROR_TOM	不能查看明日奖励信息！	Không thể xem thông tin thưởng ngày mai
E_STR_AWARD_TIME	领奖倒计时：	Nhận thưởng còn:
HELP_RECHANGEREB_1	活动当天玩家充值元宝数达到特定金额，可在活动第二天领取相应元宝及物品奖励	Trong ngày hoạt động người chơi nạp đạt số lượng KNB nhất định, nhận được thưởng vật phẩm và KNB tương ứng vào ngày thứ 2
HELP_RECHANGEREB_2	活动结束后,充值金额3000元宝及以上的玩家可争夺排行榜奖励	Sau khi hoạt động kết thúc, người chơi nạp 3000 KNB và trên 3000 KNB có thể tranh đoạt thưởng BXH
HELP_RECHANGEREB_3	玩家领取奖励时只能领取充值元宝数对应最高档次的奖励	Khi người chơi nhận thưởng chỉ được nhận thưởng xếp hạng cao nhất tương ứng số KNB nạp
HELP_RECHANGEREB_4	活动结束后将会有一天领奖倒计时，请玩家在活动关闭前及时领取，以免造成损失	Sau khi hoạt động kết thúc sẽ có đếm ngược nhận thưởng 1 ngày, người chơi kịp thời nhận trước khi hoạt động kết thúc để tránh tổn thất
E_STR_DISCOUNT_SHOP_HELP_DESC1	特惠商为限时活动，活动结束后，特惠商店将消失	Tiệm Giảm Giá là hoạt động hạn giờ, sau khi hoạt động kết thúc, Tiệm này sẽ mất
E_STR_DISCOUNT_SHOP_HELP_DESC2	活动期间，商店会进行优惠打折活动，以极低的价格进行出售游戏内稀缺的武将碎片和稀缺道具	Thời gian hoạt động, Tiệm sẽ tiến hành hoạt động giảm giá, và tiến hành bán Mảnh Võ Tướng hiếm và đạo cụ hiếm trong game với giá cực thấp
E_STR_DISCOUNT_SHOP_HELP_DESC3	随着购买次数的增加，商品的售价会逐步提高，达到当日售价上限后便不再增加；各个商品之间的售价单独计算购买次数，不相互影响	Số lần mua tăng, giá bán thương phẩm sẽ dần tăng, sau khi đạt giới hạn giá bán trong ngày sẽ không tăng nữa; Giá bán giữa các thương phẩm tính riêng lẻ số lần mua, không ảnh hưởng nhau
E_STR_DISCOUNT_SHOP_HELP_DESC4	商品售价在晚上24:00进行重置，重置后玩家可以再次从最低价格开始购买物品	Thiết lập lại giá bán thương phẩm lúc 24:00, thiết lập xong người chơi bắt đầu mua vật phẩm từ giá thấp nhất
E_STR_DISCOUNT_SHOP_HELP_DESC5	特惠商店活动次数有限，请各位玩家抓紧机会哦	Số lần hoạt động Tiệm Giảm Giá có hạn, người chơi nên nắm bắt cơ hội
E_STR_RECHARGEANDPAY_HELP1	储值元宝超过3000元宝和消费元宝3000元宝可争夺排行榜奖励。	Nạp thẻ quá 3000 KNB và tiêu phí 3000 KNB có thể tranh đoạt Thưởng BXH.
E_STR_RECHARGEANDPAY_HELP2	储值排行榜与消费排行榜显示本周储值消费前三玩家角色名。	BXH nạp thẻ và BXH tiêu phí hiển thị Top 3 nhân vật người chơi nạp thẻ tiêu phí.
E_STR_RECHARGEANDPAY_HELP3	排行榜将会在每周星期天晚上0点前结算，排行榜上玩家可在次日进入界面领取奖励。	BXH sẽ tổng kết trước 00:00 tối mỗi chủ nhật, người chơi lên BXHCó thể vào giao diện nhận thưởng ngày thứ 2.
E_STR_RECHARGEANDPAY_HELP4	每周一为领奖时间，上周上榜玩家可在周一领取奖励。玩家周一储值消费的元宝将会计算在储值消费排行榜中。	Thứ 2 mỗi tuần là thời gian nhận, người chơi lên bảng tuần trước có thể nhận thưởng vào ngày thứ 2.KNB nạp thẻ tiêu phí thứ 2 sẽ tính vào BXH nạp thẻ tiêu phí.
E_STR_RECHARGEANDPAY_HELP5	进入排行榜玩家请在周一完成奖励领取，以免照成损失。	Người chơi vào BXH, vào thứ 2 hãy hoàn tất nhận thưởng để tránh tổn thất.
E_STR_RECHARGEANDPAY_PAYINFO	本周消费元宝数:	Số NB tốn tuần này:
E_STR_RECHARGEANDPAY_RECHARGEINFO	本周充值元宝数:	Số NB nạp tuần này:
E_STR_RECHARGEANDPAY_CANGOT	领取	Nhận
E_STR_HORSE_HELP1	坐骑系统在君主达到45级时开放，该系统可以为武将提供大量加成属性	Quân Chủ đạt cấp 45 mở thú cưỡi, hệ thống này có thể giúp Võ Tướng tăng nhiều thuộc tính
E_STR_HORSE_HELP2	坐骑开启后，武将自动获得马鞭、马鞍两件坐骑装备，同时也可在马场获取坐骑，马匹、马鞭、马鞍均能为武将带来属性加成，等级越高，加成属性越多	Sau khi mở thú cưỡi, Võ Tướng tự động nhận 2 trang bị thú cưỡi Roi Ngựa, Yên Ngựa, đồng thời cũng có thể nhận được thú cưỡi, Roi Ngựa, Yên Ngựa ở Trường Ngựa mang lại thuộc tính cho Võ Tướng, cấp càng cao, thuộc tính càng nhiều
E_STR_HORSE_HELP3	武将装备特定坐骑，能获得额外的缘分属性加成，马鞭马鞍升级到特定等级时，也能为武将提供额外的属性加成效果	Trang bị Võ Tướng xác định thú cưỡi, có thể nhận thêm thuộc tính duyên phận, khi Roi Ngựa Yên Ngựa tăng đến cấp nhất định, có thể giúp Võ Tướng tăng thêm hiệu ứng thuộc tính
E_STR_HORSE_HELP4	马匹升级，需要消耗一定数量的同样1级马匹，马鞭马鞍升级需要消耗一定数量的指定道具	Tăng cấp ngựa, cần tốn Ngựa cấp 1 số lượng nhất định, tăng cấp Roi Ngựa và Yên Ngựa cần tốn đạo cụ số lượng nhất định
E_STR_HORSE_HELP5	玩家在马场可以通过消耗套马道具进行套马以获取马匹。套马道具有2种，普通道具套马时，套马次数越多，消耗的道具数量也逐渐增加，直至到达每日消耗上限为止，使用高级套马道具套马时，每次固定消耗1个	Người chơi ở Trường Ngựa tốn đạo cụ chọn ngựa. Đạo cụ chọn ngựa có 2 loại, dùng đạo cụ thường chọn ngựa, chọn càng nhiều đạo cụ tốn dần tăng, đến giới hạn tốn mỗi ngày sẽ dừng, khi dùng đạo cụ chọn ngựa cấp cao mỗi lần chỉ tốn 1 cái
E_STR_HORSE_HELP6	每天使用普通道具套马时的道具消耗数量，在晚上24:00时进行重置	Mỗi ngày tốn số lượng đạo cụ khi dùng đạo cụ thường chọn ngựa sẽ thiết lập lại lúc 24:00
E_STR_HORSE_HELP7	普通套马道具可以使用金币或马券兑换得到，高级套马道具可以使用元宝和马券兑换得到	Đạo cụ chọn ngựa thường dùng Vàng hoặc Phiếu Ngựa đổi nhận được, đạo cụ chọn ngựa cao cấp dùng KNB và Phiếu Ngựa đổi nhận được
E_STR_HORSE_HELP8	玩家得到马匹后，可以自行装备马匹，也可以将马匹出售获得马券	Sau khi người chơi nhận được ngựa, tự trang bị ngựa, có thể bán ngựa nhận được Phiếu Ngựa
E_STR_HORSE_HELP9	马券可以用于在马场兑换指定马匹，或者用于购买马鞭、马鞍升级道具，也可用于购买套马道具以进行套马	Phiếu Ngựa có thể dùng ở Trường Ngựa đổi ngựa nhất định, hoặc để mua đạo cụ tăng cấp Roi Ngựa, Yên Ngựa, cũng có thể dùng mua đạo cụ chọn ngựa để chọn ngựa
E_STR_LOGIN_NO_INPUT	您没有输入登录名或密码	Bạn chưa nhập tên đăng nhập hoặc mật khẩu
E_STR_LOGIN_DESC1	请输入验证码卡	Vui lòng nhập mã thẻ
E_STR_LOGIN_DESC2	请输入序列号	Vui lòng nhập số serial
E_STR_LOGIN_DESC3	请输入PIN码	Vui lòng nhập mã pin
E_STR_LOGIN_DESC4	您没有输入足够的信息。	Bạn chưa nhập đủ thông tin.
E_STR_NOT_BUY	该等级宝石尚未开放购买	Bảo Thạch LV này chưa cho phép mua
E_STR_TEN_SHOT	武将十连抽有几率抽出超级彩将，请问主公是否需要召唤猛将？	Rút thẻ tướng 10 lần có khả năng nhận được Thần Tướng, Chúa Công có muốn chiêu mộ mãnh tướng ?
E_STR_TOWER_CHALLENGE		Tầng <font color='#00FF00'>%d</font> đạt được
E_STR_CANNOT_GET	无法领取	Không nhận được
E_STR_HORSE_NOHORSE	没有对应的马匹	Không có ngựa tương ứng
E_STR_RECHANGEREB_DESC	充值金额：	Số tiền nạp:
E_STR_LUCK_GO_HELP_1	活动期间玩家每储值1元宝将获得1积分。活动期间每天免费赠送500积分。	Trong thời gian sự kiện người chơi tích lũy 1 KNB sẽ được 1 điểm. Trong thời gian sự kiện mỗi ngày được tặng 500 điểm.
E_STR_LUCK_GO_HELP_2	每次消耗积分转动获得奖励。有机会转到多倍，获得多倍奖励。每转到一次多倍，下次转动消耗积分增加，直到转到物品后重置。	Mỗi lần dùng điểm xoay để nhận quà. Có thể xoay được nhiều lần, nhận được nhiều phần thưởng gấp đôi. Mỗi khi xoay được nhiều lần, lần xoay sau sẽ tiêu hao nhiều điểm hơn, cho đến khi quay được vật phẩm sẽ làm mới lại.
E_STR_LUCK_GO_HELP_3	消耗积分点击刷新按钮，可刷新奖励内容，刷新消耗积分将递增。活动期间请及时使用积分，活动结束后积分将会清零。	Dùng điểm để nhấn nút làm mới, có thể làm mới phần thưởng, điểm tiêu hao sẽ tăng dần. Trong thời gian sự kiện nhớ dùng điểm kịp thời, kết thúc sự kiện điểm sẽ được xóa hết.
E_STR_LUCK_GO_HELP_4	转动次数超过30次可进入排行榜，活动结束后可领取排行榜奖励。请及时领取奖励，以免玩家造成损失。	Số lần xoay vượt quá 30 sẽ được vào bảng xếp hạng, khi kết thúc sự kiện có thể nhận thưởng xếp hạng. Xin nhận thưởng kịp lúc, để tránh bị tổn thất.
E_STR_OB		CB là không mở trong việc nạp tiền
